Asperger综合征	zhengzhuang/aspergerzhz/
阿罗瞳孔	zhengzhuang/altk/
阿司匹林过敏	zhengzhuang/asplgm/
癌细胞逆行播散	zhengzhuang/axbnxbs/
癌性发热	zhengzhuang/axfr/
癌性输尿管狭窄	zhengzhuang/axsngxz/
癌症晚期胃肠道症状	zhengzhuang/azwqwcdzz/
嗳腐	zhengzhuang/af/
嗳气	zhengzhuang/aq/
嗳气时有腐败鸡蛋的气味	zhengzhuang/aqsyfbjddqw/
安静腹	zhengzhuang/ajf/
氨基酸尿症	zhengzhuang/ajsnz/
鞍鼻	zhengzhuang/ab/
凹甲	zhengzhuang/aj/
凹陷瘢痕	zhengzhuang/axbh/
凹陷性疤痕	zhengzhuang/axxbh/
β-氨基酸尿	zhengzhuang/_ajsn/
八字脚步态	zhengzhuang/bzjbt/
疤痕处破损后出现溃疡	zhengzhuang/bhcpshcxky/
疤痕奇痒	zhengzhuang/bhqy/
疤痕体质	zhengzhuang/bhtz/
疤痕萎缩凹陷	zhengzhuang/bhwsax/
疤痕形成	zhengzhuang/bhxc/
疤痕增生	zhengzhuang/bhzs/
拔牙后出血不止	zhengzhuang/byhcxbz/
拔牙后伤口经久不愈	zhengzhuang/byhskjjby/
白带	zhengzhuang/bd/
白带增多	zhengzhuang/bdzd/
白痱	zhengzhuang/bf/
白喉假膜形成	zhengzhuang/bhjmxc/
白甲	zhengzhuang/bj/
白色恶露	zhengzhuang/bsel/
白色黏液状尿	zhengzhuang/bsnyzn/
白色尿液	zhengzhuang/bsny/
白天不自觉地将牙咬紧	zhengzhuang/btbzjdjyyj/
白天嗜睡夜间失眠	zhengzhuang/btssyjsm/
白头粉刺	zhengzhuang/btfc/
白细胞减少	zhengzhuang/bxbjs/
白细胞尿	zhengzhuang/bxbn/
白细胞增多	zhengzhuang/bxbzd/
白血病细胞浸润	zhengzhuang/bxbxbjr/
白晕	zhengzhuang/by/
白渣样鼻涕	zhengzhuang/bzybt/
百特异症状	zhengzhuang/btyzz/
柏油便	zhengzhuang/byb/
败血症	zhengzhuang/bxz/
败血症的征象	zhengzhuang/bxzdzx/
白色念珠菌感染	zhengzhuang/bsnzjgr/
猜疑	zhengzhuang/cy/
菜花耳	zhengzhuang/che/
餐后发作性腹痛	zhengzhuang/chfzxft/
餐后血糖高	zhengzhuang/chxtg/
餐后血糖过低	zhengzhuang/chxtgd/
餐后综合征	zhengzhuang/chzhz/
残株型骨折	zhengzhuang/czxgz/
侧肋骨痛	zhengzhuang/clgt/
侧卧时位于下侧鼻腔出现鼻塞	zhengzhuang/cwswyxcbqcxbs/
产道裂伤	zhengzhuang/cdls/
产妇颈背酸痛	zhengzhuang/cfjbst/
产后便血	zhengzhuang/chbx/
产后垂体坏死	zhengzhuang/chcths/
产后恶露不净有臭味	zhengzhuang/chelbjycw/
产后发热	zhengzhuang/chfr/
产后肥胖	zhengzhuang/chfp/
产后腹痛	zhengzhuang/chft/
产后极度虚弱	zhengzhuang/chjdxr/
产后极端行为	zhengzhuang/chjdxw/
产后口渴	zhengzhuang/chkk/
产后全身酸痛	zhengzhuang/chqsst/
产后手指痛	zhengzhuang/chszt/
产后头痛	zhengzhuang/chtt/
产后脱发	zhengzhuang/chtf/
斑丘疹	zhengzhuang/bqz/
斑丘疹	zhengzhuang/bqz_85/
斑秃	zhengzhuang/bt/
斑疹	zhengzhuang/bz/
板状腹	zhengzhuang/bzf/
半侧面部发育不良	zhengzhuang/bcmbfybl/
半年或1岁以后逐步出现智能减退	zhengzhuang/bnh1syhzbcxznjt/
半乳糖血症	zhengzhuang/brtxz/
伴高血压	zhengzhuang/bgxy/
伴皮膜粘膜出血	zhengzhuang/bpmzmcx/
伴有生动鲜明的恐怖性幻视	zhengzhuang/bysdxmdkbxhs/
瓣膜小叶增厚	zhengzhuang/bmxyzh/
瓣膜增厚	zhengzhuang/bmzh/
膀胱结石	zhengzhuang/bgjs/
包皮粘连	zhengzhuang/bpzl/
宝宝缺乏安全感	zhengzhuang/bbqfaqg/
饱食后胸痛	zhengzhuang/bshxt/
保持睡眠障碍性失眠	zhengzhuang/bcsmzaxsm/
豹纹状眼底	zhengzhuang/bwzyd/
暴发性痛	zhengzhuang/bfxt/
暴力冲动行为	zhengzhuang/blcdxw/
暴力作用后腹痛	zhengzhuang/blzyhft/
暴怒	zhengzhuang/bn/
暴晒后的皮肤损害	zhengzhuang/bshdpfsh/
暴牙	zhengzhuang/by_109/
暴饮暴食	zhengzhuang/bybs/
暴胀的颞浅动脉	zhengzhuang/bzdnqdm/
爆发性水泻	zhengzhuang/bfxsx/
杯状耳	zhengzhuang/bze/
背部长痘	zhengzhuang/bbcd/
背部出现小水泡	zhengzhuang/bbcxxsp/
背部痉挛	zhengzhuang/bbjl/
背部酸痛	zhengzhuang/bbst/
背部有隐约麻痛不适	zhengzhuang/bbyyymtbs/
背脊痛	zhengzhuang/bjt/
背痛	zhengzhuang/bt_120/
被害妄想	zhengzhuang/bhwx/
被迫体位	zhengzhuang/bptw/
奔马律心音	zhengzhuang/bmlxy/
贲门弛缓	zhengzhuang/bmch/
苯丙氨酸代谢障碍	zhengzhuang/bbasdxza/
逼尿肌不稳定	zhengzhuang/bnjbwd/
逼尿肌反射亢进	zhengzhuang/bnjfskj/
逼尿肌无反射	zhengzhuang/bnjwfs/
鼻部结核	zhengzhuang/bbjh/
鼻臭症	zhengzhuang/bcz/
鼻出血	zhengzhuang/bcx/
鼻唇沟变浅	zhengzhuang/bcgbq/
鼻唇沟发红皲裂	zhengzhuang/bcgfhjl/
鼻唇沟加深	zhengzhuang/bcgjs/
鼻窦气压伤	zhengzhuang/bdqys/
鼻窦压痛	zhengzhuang/bdyt/
鼻端出火	zhengzhuang/bdch/
鼻端肥大	zhengzhuang/bdfd/
鼻端弥漫性潮红	zhengzhuang/bdmmxch/
鼻端缺损	zhengzhuang/bdqs/
鼻端形态不佳	zhengzhuang/bdxtbj/
鼻分泌物增多	zhengzhuang/bfmwzd/
鼻干	zhengzhuang/bg/
鼻干	zhengzhuang/bg_146/
鼻根部水肿	zhengzhuang/bgbsz/
鼻和喉部灼热感	zhengzhuang/bhhbzrg/
鼻甲萎缩	zhengzhuang/bjws/
鼻甲肿胀	zhengzhuang/bjzz/
鼻尖或鼻翼出现带状疱疹	zhengzhuang/bjhbycxdzpz/
鼻尖上翘呈马鞍状	zhengzhuang/bjsqcmaz/
鼻孔闭锁	zhengzhuang/bkbs/
鼻孔朝天或鼻孔前倾	zhengzhuang/bkcthbkqq/
鼻孔干疼	zhengzhuang/bkgt/
鼻孔流脓	zhengzhuang/bkln/
鼻泪管阻塞	zhengzhuang/blgzs/
鼻梁低	zhengzhuang/bld/
鼻梁平塌	zhengzhuang/blpt/
鼻裂	zhengzhuang/bl/
鼻毛脱落	zhengzhuang/bmtl/
鼻内似有擤不出的鼻涕	zhengzhuang/bnsyxbcdbt/
鼻内痛	zhengzhuang/bnt/
鼻黏膜和鼻甲萎缩	zhengzhuang/bnmhbjws/
鼻黏膜可呈颗粒状易碎的结痂	zhengzhuang/bnmkcklzysdjj/
鼻黏膜溃疡	zhengzhuang/bnmky/
鼻脓涕有臭味	zhengzhuang/bntycw/
鼻衂	zhengzhuang/bn_170/
鼻衄	zhengzhuang/bn_171/
鼻旁窦发育不良	zhengzhuang/bpdfybl/
鼻前庭部发痒	zhengzhuang/bqtbfy/
鼻前庭囊肿	zhengzhuang/bqtnz/
鼻前庭皮肤红肿疼痛	zhengzhuang/bqtpfhztt/
鼻腔不能关闭引起的鼻音	zhengzhuang/bqbngbyqdby/
鼻腔干燥及结痂	zhengzhuang/bqgzjjj/
鼻腔前部出血	zhengzhuang/bqqbcx/
鼻腔中后部出血	zhengzhuang/bqzhbcx/
鼻塞	zhengzhuang/bs/
鼻塞及反射性头痛	zhengzhuang/bsjfsxtt/
鼻塞排出脓性或血性分泌物	zhengzhuang/bspcnxhxxfmw/
鼻煽	zhengzhuang/bs_183/
鼻屎多	zhengzhuang/bsd/
鼻外部膨胀隆起	zhengzhuang/bwbpzlq/
鼻咽癌的远处转移	zhengzhuang/byadyczy/
鼻咽腔狭窄	zhengzhuang/byqxz/
鼻咽异物	zhengzhuang/byyw/
鼻痒	zhengzhuang/by_190/
鼻溢液	zhengzhuang/byy/
鼻翼边缘缺损	zhengzhuang/bybyqs/
鼻翼厚	zhengzhuang/byh/
鼻翼两侧脱皮	zhengzhuang/bylctp/
鼻翼扇动	zhengzhuang/bysd/
鼻翼上方缺损	zhengzhuang/bysfqs/
鼻粘膜苍白水肿	zhengzhuang/bzmcbsz/
鼻粘膜干燥发痒	zhengzhuang/bzmgzfy/
鼻粘膜溃疡	zhengzhuang/bzmky/
鼻粘膜溃疡和萎缩	zhengzhuang/bzmkyhws/
鼻粘膜肿胀	zhengzhuang/bzmzz/
鼻中隔穿孔	zhengzhuang/bzgck/
鼻中隔或鼻腔内软骨暴露	zhengzhuang/bzghbqnrgbl/
鼻中隔向一侧或两则弯曲	zhengzhuang/bzgxychlzwq/
鼻子发黑	zhengzhuang/bzfh/
鼻子红血丝	zhengzhuang/bzhxs/
鼻子黄色或棕色	zhengzhuang/bzhshzs/
鼻子颜色苍白	zhengzhuang/bzyscb/
吡咯烷及呱啶尿	zhengzhuang/bkwjgdn/
闭经	zhengzhuang/bj_211/
闭经-乳溢-不育三联征	zhengzhuang/bj_ry_byslz/
闭目难立征	zhengzhuang/bmnlz/
闭眼站立不能	zhengzhuang/byzlbn/
闭症	zhengzhuang/bz_216/
蓖麻子便中常见蓖麻子外皮碎屑	zhengzhuang/bmzbzcjbmzwpsx/
臂丛神经受累	zhengzhuang/bcsjsl/
边缘溃疡性角膜炎	zhengzhuang/bykyxjmy/
扁脸	zhengzhuang/bl_221/
扁平骨盆	zhengzhuang/bpgp/
扁平苔癣	zhengzhuang/bptx/
扁平型骨盆	zhengzhuang/bpxgp/
扁平足	zhengzhuang/bpz/
扁桃体变小而坚韧	zhengzhuang/bttbxejr/
扁桃体充血	zhengzhuang/bttcx/
扁桃体充血肥大	zhengzhuang/bttcxfd/
扁桃体肥大	zhengzhuang/bttfd/
扁桃体上有灰色膜	zhengzhuang/bttsyhsm/
扁桃体小或缺如	zhengzhuang/bttxhqr/
便秘	zhengzhuang/bm/
便秘伴腹部包块	zhengzhuang/bmbfbbk/
便秘伴剧烈腹痛	zhengzhuang/bmbjlft/
便稀时经阴道排出	zhengzhuang/bxsjydpc/
便鲜红血呈点滴状或喷射状	zhengzhuang/bxhxcddzhpsz/
扳机指的弹响	zhengzhuang/bjzddx/
抱癖	zhengzhuang/bp/
被动体位	zhengzhuang/bdtw/
被窃或疑病妄想	zhengzhuang/bqhybwx/
鼻孔外露	zhengzhuang/bkwl/
鼻毛变白	zhengzhuang/bmbb/
鼻小柱缺损	zhengzhuang/bxzqs/
鼻子长痘	zhengzhuang/bzcd/
闭孔神经损害	zhengzhuang/bksjsh/
臂痛	zhengzhuang/bt_246/
便血	zhengzhuang/bx/
便血且血与粪便混合	zhengzhuang/bxqxyfbhh/
变应性鼻炎	zhengzhuang/byxby/
变应性咳嗽	zhengzhuang/byxks/
表皮发生钙化	zhengzhuang/bpfsgh/
表皮角化	zhengzhuang/bpjh/
表皮全层坏死及表皮下大疱	zhengzhuang/bpqchsjbpxdp/
表情迟钝	zhengzhuang/bqcd/
表情淡漠	zhengzhuang/bqdm/
表演型人格障碍	zhengzhuang/byxrgza/
髌骨骨裂	zhengzhuang/bggl/
髌骨劳损	zhengzhuang/bgls/
髌骨缺失或发育不良	zhengzhuang/bgqshfybl/
髌骨软化	zhengzhuang/bgrh/
髌骨疼痛	zhengzhuang/bgtt/
髌后捻发音	zhengzhuang/bhnfy/
髌后疼痛	zhengzhuang/bhtt/
髌前空虚感	zhengzhuang/bqkxg/
髌下疼痛	zhengzhuang/bxtt/
髌周指压痛	zhengzhuang/bzzyt/
并指（趾）畸形	zhengzhuang/bz_z_jx/
病毒性腹泻	zhengzhuang/bdxfx/
病理性Q波	zhengzhuang/blxqb/
病理性REM睡眠	zhengzhuang/blxremsm/
病理性赌博	zhengzhuang/blxdb/
病理性发笑和哭喊	zhengzhuang/blxfxhkh/
病理性钙化	zhengzhuang/blxgh/
病理性黄疸	zhengzhuang/blxhd/
病理性近视	zhengzhuang/blxjs/
病理性神经损伤	zhengzhuang/blxsjss/
病理性听觉适应	zhengzhuang/blxtjsy/
病理性偷窃	zhengzhuang/blxtq/
病理性脱发	zhengzhuang/blxtf/
病理性赘述	zhengzhuang/blxzs/
病理性纵火	zhengzhuang/blxzh/
病理性醉酒	zhengzhuang/blxzj/
病态欣快感	zhengzhuang/btxkg/
波动性听力减退	zhengzhuang/bdxtljt/
玻璃体经瞳孔向前房凸出	zhengzhuang/bltjtkxqftc/
玻璃体内可见球形囊体	zhengzhuang/bltnkjqxnt/
玻璃体有血迹	zhengzhuang/bltyxj/
剥夺性弱视	zhengzhuang/bdxrs/
剥脱性皮炎	zhengzhuang/btxpy/
脖子扭痛	zhengzhuang/bznt/
搏动性耳鸣	zhengzhuang/bdxem/
搏动性头痛	zhengzhuang/bdxtt/
捕蝇舌征	zhengzhuang/bysz/
不典型胸痛	zhengzhuang/bdxxt/
不典型增生	zhengzhuang/bdxzs/
不断眨眼	zhengzhuang/bdzy/
不规则热	zhengzhuang/bgzr/
不可克制的饮酒冲动	zhengzhuang/bkkzdyjcd/
不良建筑综合征	zhengzhuang/bljzzhz/
不良睡眠卫生	zhengzhuang/blsmws/
不明原因发热	zhengzhuang/bmyyfr/
不能持续睁眼	zhengzhuang/bncxzy/
不能露齿及突唇	zhengzhuang/bnlcjtc/
不能屈膝	zhengzhuang/bnqx/
不能伸展拇指	zhengzhuang/bnszmz/
不能向尺侧屈腕及屈环小指远侧指关节	zhengzhuang/bnxccqwjqhxzyczgj/
不能眨眼	zhengzhuang/bnzy/
不能转颈	zhengzhuang/bnzj/
不宁腿综合征	zhengzhuang/bntzhz/
不排卵	zhengzhuang/bpl/
不排胎便	zhengzhuang/bptb/
不偏向一侧，无旋转的眩晕	zhengzhuang/bpxyc_wxzdxy/
不全流产	zhengzhuang/bqlc/
不完全性房内阻滞	zhengzhuang/bwqxfnzz/
不稳定性心绞痛	zhengzhuang/bwdxxjt/
不协调性兴奋	zhengzhuang/bxdxxf/
不真实感	zhengzhuang/bzsg/
不自主运动	zhengzhuang/bzzyd/
步态不稳	zhengzhuang/btbw/
步态异常	zhengzhuang/btyc/
部位不定的疼痛	zhengzhuang/bwbddtt/
黑色鼻涕	zhengzhuang/hsbt/
脾气变坏	zhengzhuang/pqbh/
偏侧不注意	zhengzhuang/pcbzy/
CO2潴留	zhengzhuang/co2zl/
侧脑室增宽	zhengzhuang/cnszk/
侧支循环发育不充	zhengzhuang/czxhfybc/
层状鱼鳞癣	zhengzhuang/czylx/
岔气	zhengzhuang/cq/
产道扁平型狭窄	zhengzhuang/cdbpxxz/
产道血肿	zhengzhuang/cdxz/
产后便秘	zhengzhuang/chbm/
产后出血	zhengzhuang/chcx/
产后大便失禁	zhengzhuang/chdbsj/
产后乳房萎缩	zhengzhuang/chrfws/
产后无乳汁分泌	zhengzhuang/chwrzfm/
产后下腹坠痛或阴道坠胀感	zhengzhuang/chxfzthydzzg/
产后小便频数或小便失禁	zhengzhuang/chxbpshxbsj/
产后小腹坠痛	zhengzhuang/chxfzt/
产后胸部下垂	zhengzhuang/chxbxc/
产后血气痛	zhengzhuang/chxqt/
产后血晕	zhengzhuang/chxy/
产后抑郁	zhengzhuang/chyy/
产后月经不再来潮	zhengzhuang/chyjbzlc/
产后子宫收缩	zhengzhuang/chzgss/
产后自汗盗汗	zhengzhuang/chzhdh/
产力异常	zhengzhuang/clyc/
产褥感染	zhengzhuang/crgr/
产褥期恶露	zhengzhuang/crqel/
产褥期幻觉妄想状态	zhengzhuang/crqhjwxzt/
产褥期躁狂状态	zhengzhuang/crqzkzt/
产褥期谵妄状态	zhengzhuang/crqzwzt/
产育过多后腰痛	zhengzhuang/cygdhyt/
颤抖	zhengzhuang/cd/
长段升主动脉发育不全	zhengzhuang/cdszdmfybq/
长骨粗大	zhengzhuang/cgcd/
长骨骨骺端钙化不全	zhengzhuang/cgghdghbq/
长骨肿胀疼痛	zhengzhuang/cgzztt/
长脉	zhengzhuang/cm/
长期的盆腔疼痛	zhengzhuang/cqdpqtt/
长期使用皮质类固醇导致肌肉病变	zhengzhuang/cqsypzlgcdzjrbb/
长期使用糖皮质激素导致的损害	zhengzhuang/cqsytpzjsdzdsh/
长时间或剧烈运动后前足疼痛	zhengzhuang/csjhjlydhqztt/
长头畸形	zhengzhuang/ctjx/
长头巨脑	zhengzhuang/ctjn/
肠闭锁	zhengzhuang/cbs/
肠壁坏死	zhengzhuang/cbhs/
肠壁水肿增厚	zhengzhuang/cbszzh/
盲肠阿米巴肉芽肿	zhengzhuang/mcambryz/
肠出血	zhengzhuang/ccx/
肠穿孔	zhengzhuang/cck/
肠道功能紊乱	zhengzhuang/cdgnwl/
肠道蛔虫感染	zhengzhuang/cdhcgr/
肠道吸收水分增加	zhengzhuang/cdxssfzj/
肠道血管畸形	zhengzhuang/cdxgjx/
肠道张力减低	zhengzhuang/cdzljd/
肠道转运障碍	zhengzhuang/cdzyza/
肠梗死	zhengzhuang/cgs/
肠管变形	zhengzhuang/cgbx/
肠管出血	zhengzhuang/cgcx/
肠痉挛	zhengzhuang/cjl/
肠麻痹	zhengzhuang/cmb/
肠麻痹软瘫	zhengzhuang/cmbrt/
肠鸣	zhengzhuang/cm_384/
肠鸣音消失	zhengzhuang/cmyxs/
肠囊性积气	zhengzhuang/cnxjq/
肠绒毛萎缩	zhengzhuang/crmws/
肠蠕动减慢	zhengzhuang/crdjm/
肠蠕动减少	zhengzhuang/crdjs/
肠套叠	zhengzhuang/ctd/
肠外结核	zhengzhuang/cwjh/
肠系膜囊肿	zhengzhuang/cxmnz/
肠狭窄	zhengzhuang/cxz/
肠易激综合征	zhengzhuang/cyjzhz/
肠壅积	zhengzhuang/cyj/
肠粘连	zhengzhuang/czl/
肠粘膜脱落	zhengzhuang/czmtl/
肠粘膜有坏死溃疡	zhengzhuang/czmyhsky/
肠胀气	zhengzhuang/czq/
常染色体畸变	zhengzhuang/crstjb/
场所恐惧	zhengzhuang/cskj/
超雌	zhengzhuang/cc/
超量饮酒后两下肢突然出现痉挛和疼痛	zhengzhuang/clyjhlxztrcxjlhtt/
超雄	zhengzhuang/cx/
潮汗	zhengzhuang/ch/
潮红潮热	zhengzhuang/chcr/
潮式呼吸	zhengzhuang/cshx/
晨僵	zhengzhuang/cj/
晨起肥皮肿	zhengzhuang/cqfpz/
晨起前额疼，午后减轻	zhengzhuang/cqqet_whjq/
晨起时颈背部弥漫性剧痛	zhengzhuang/cqsjbbmmxjt/
成年后的容貌仍似儿童	zhengzhuang/cnhdrmrset/
成人多动症	zhengzhuang/crddz/
成人生长激素分泌不足	zhengzhuang/crscjsfmbz/
成瘾	zhengzhuang/cy_415/
呈红色条索，游走的浅静脉	zhengzhuang/chsts_yzdqjm/
呈开口状态而不能闭合	zhengzhuang/ckkztebnbh/
呈马蜂螫型游走性水肿	zhengzhuang/cmfsxyzxsz/
呈泡沫样有腥臭味稀便	zhengzhuang/cpmyyxcwxb/
呈肾上腺素能依赖性	zhengzhuang/cssxsnylx/
痴呆	zhengzhuang/cd_421/
痴呆面容	zhengzhuang/cdmr/
痴笑	zhengzhuang/cx_423/
弛张热	zhengzhuang/czr/
迟脉	zhengzhuang/cm_425/
持物不稳	zhengzhuang/cwbw/
持续的肌肉收缩	zhengzhuang/cxdjrss/
持续低烧	zhengzhuang/cxds/
持续发烧	zhengzhuang/cxfs/
持续高烧	zhengzhuang/cxgs/
持续颅内杂音	zhengzhuang/cxlnzy/
持续性肠绞痛	zhengzhuang/cxxcjt/
持续性弛张热	zhengzhuang/cxxczr/
持续性发热	zhengzhuang/cxxfr/
持续性剧烈的肩痛	zhengzhuang/cxxjldjt/
持续性咳嗽	zhengzhuang/cxxks/
持续性尿蛋白	zhengzhuang/cxxndb/
持续性疼痛	zhengzhuang/cxxtt/
持续性头晕	zhengzhuang/cxxty/
持续性下腹疼痛	zhengzhuang/cxxxftt/
持续性胸部疼痛或模糊的背部疼痛	zhengzhuang/cxxxbtthmhdbbtt/
持续性腰痛伴有晨僵	zhengzhuang/cxxytbycj/
尺动脉或桡动脉搏动减弱和消失	zhengzhuang/cdmhrdmbdjrhxs/
齿轮样强直	zhengzhuang/clyqz/
齿龈出血	zhengzhuang/cycx/
齿龈肥厚	zhengzhuang/cyfh/
齿龈铅线	zhengzhuang/cyqx/
齿龈炎	zhengzhuang/cyy/
齿龈有蓝线	zhengzhuang/cyylx/
齿龈增生	zhengzhuang/cyzs/
齿龈肿胀	zhengzhuang/cyzz/
耻骨联合分离	zhengzhuang/cglhfl/
耻骨上痛	zhengzhuang/cgst/
耻骨直肠肌痉挛性肥大	zhengzhuang/cgzcjjlxfd/
耻区肿块	zhengzhuang/cqzk/
充血	zhengzhuang/cx_456/
冲动毁物	zhengzhuang/cdhw/
冲动型人格障碍	zhengzhuang/cdxrgza/
抽搐	zhengzhuang/cc_459/
抽动障碍	zhengzhuang/cdza/
抽风	zhengzhuang/cf/
抽筋	zhengzhuang/cj_462/
臭汗	zhengzhuang/ch_463/
出汗减少	zhengzhuang/chjs/
出汗异常	zhengzhuang/chyc/
出冷汗	zhengzhuang/clh/
出生后“四凹征”	zhengzhuang/csh_saz_/
出生后即有持续青紫	zhengzhuang/cshjycxqz/
出生时小头	zhengzhuang/cssxt/
出现毒性颗粒	zhengzhuang/cxdxkl/
出现喉结	zhengzhuang/cxhj/
出血利坏死	zhengzhuang/cxlhs/
出血倾向	zhengzhuang/cxqx/
出血性梗死	zhengzhuang/cxxgs/
出血性丘疹	zhengzhuang/cxxqz/
初生婴儿即出现侏儒状态	zhengzhuang/csyejcxzrzt/
处女膜无孔	zhengzhuang/cnmwk/
触觉失调	zhengzhuang/cjsd/
触诊无肺动脉关闭感	zhengzhuang/czwfdmgbg/
川字纹	zhengzhuang/czw/
穿透性皮肤变性	zhengzhuang/ctxpfbx/
穿凿样改变颅骨破坏	zhengzhuang/czygblgph/
传导性耳聋	zhengzhuang/cdxel/
传导性耳鸣	zhengzhuang/cdxem/
传导性腹痛	zhengzhuang/cdxft/
传导阻滞	zhengzhuang/cdzz/
喘息	zhengzhuang/cx_487/
串珠肋	zhengzhuang/czl_488/
创伤	zhengzhuang/cs/
创伤性宫腔粘连	zhengzhuang/csxgqzl/
垂体功能减退	zhengzhuang/ctgnjt/
垂体功能紊乱	zhengzhuang/ctgnwl/
垂体切除术后昏迷	zhengzhuang/ctqcshhm/
垂体危象	zhengzhuang/ctwx/
垂体性闭经	zhengzhuang/ctxbj/
垂腕	zhengzhuang/cw/
垂直性忽略症	zhengzhuang/czxhlz/
唇部发绀	zhengzhuang/cbfg/
唇腭裂	zhengzhuang/cel/
唇干裂	zhengzhuang/cgl/
唇干舌燥	zhengzhuang/cgsz/
唇红干燥	zhengzhuang/chgz/
唇厚舌大	zhengzhuang/chsd/
唇角脱屑	zhengzhuang/cjtx/
唇上长有小水泡	zhengzhuang/cscyxsp/
唇水疱	zhengzhuang/csp/
唇外翻	zhengzhuang/cwf/
唇圆或椭圆形红斑	zhengzhuang/cyhtyxhb/
唇周边长痘	zhengzhuang/czbcd/
唇皱褶增多畸形	zhengzhuang/czzzdjx/
雌激素不足	zhengzhuang/cjsbz/
腠理不固	zhengzhuang/clbg/
促甲状腺激素释放激素缺乏	zhengzhuang/cjzxjssfjsqf/
促脉	zhengzhuang/cm_514/
猝倒	zhengzhuang/cd_515/
猝死	zhengzhuang/cs_516/
脆性X综合征	zhengzhuang/cxxzhz/
搓手顿足	zhengzhuang/csdz/
痤疮样皮疹	zhengzhuang/ccypz/
重听	zhengzhuang/zt/
“淡漠型”甲亢	zhengzhuang/_dmx_jk/
“冻僵”现象	zhengzhuang/_dj_xx/
“多音律”心音	zhengzhuang/_dyl_xy/
肠淤滞	zhengzhuang/cyz/
搭肩试验阳性	zhengzhuang/djsyyx/
打嗝	zhengzhuang/dg/
打哈欠	zhengzhuang/dhq/
打鼾	zhengzhuang/dh/
打呼噜	zhengzhuang/dhl/
打喷嚏	zhengzhuang/dpt/
打软腿	zhengzhuang/drt/
大便变细形似铅笔	zhengzhuang/dbbxxsqb/
大便呈褐色	zhengzhuang/dbchs/
大便干结呈算盘珠状	zhengzhuang/dbgjcspzz/
大便色浅	zhengzhuang/dbsq/
大便习惯改变	zhengzhuang/dbxggb/
大便粘腻	zhengzhuang/dbzn/
大肠黑变	zhengzhuang/dchb/
大动脉错位	zhengzhuang/ddmcw/
大动脉供血障碍	zhengzhuang/ddmgxza/
大角膜	zhengzhuang/djm/
大块肝细胞坏死	zhengzhuang/dkgxbhs/
大量皮肤脱屑	zhengzhuang/dlpftx/
大量饮酒后突然视力减退	zhengzhuang/dlyjhtrsljt/
大脑发育障碍	zhengzhuang/dnfyza/
大疱（含脓性液体）	zhengzhuang/dp_hnxyt_/
大三阳	zhengzhuang/dsy/
大腿刺痛	zhengzhuang/dtct/
大腿肌肉萎缩	zhengzhuang/dtjrws/
大腿局部肿胀变形	zhengzhuang/dtjbzzbx/
大腿内侧红斑	zhengzhuang/dtnchb/
大腿外侧痛	zhengzhuang/dtwct/
大腿以下或膝以下肌肉瘫痪	zhengzhuang/dtyxhxyxjrth/
大小便失禁	zhengzhuang/dxbsj/
大小便潴留	zhengzhuang/dxbzl/
大写症	zhengzhuang/dxz/
大阴唇或肛门大小不等、质软无压痛包块	zhengzhuang/dychgmdxbd_zrwytbk/
大转子叩痛	zhengzhuang/dzzkt/
呆滞	zhengzhuang/dz/
代偿性腰椎前凸	zhengzhuang/dcxyzqt/
代偿作用	zhengzhuang/dczy/
代脉	zhengzhuang/dm/
代谢性低钾	zhengzhuang/dxxdj/
代谢性碱中毒	zhengzhuang/dxxjzd/
代谢性酸中毒	zhengzhuang/dxxszd/
带血性分泌物	zhengzhuang/dxxfmw/
带血粘脓鼻涕	zhengzhuang/dxznbt/
带状疱疹样外观	zhengzhuang/dzpzywg/
丹毒	zhengzhuang/dd/
丹毒样外观	zhengzhuang/ddywg/
单侧鼻腔阻塞	zhengzhuang/dcbqzs/
单侧及假性手足徐动	zhengzhuang/dcjjxszxd/
单侧面部萎缩	zhengzhuang/dcmbws/
单侧头痛	zhengzhuang/dctt/
单侧眼底出现肉芽肿性改变	zhengzhuang/dcydcxryzxgb/
单纯骨折	zhengzhuang/dcgz/
单纯性上半身消瘦型	zhengzhuang/dcxsbsxsx/
单纯性晕厥	zhengzhuang/dcxyj/
单纯醉酒	zhengzhuang/dczj/
单次发作抑郁症	zhengzhuang/dcfzyyz/
单发性坚实性结节	zhengzhuang/dfxjsxjj/
单角或双角子宫	zhengzhuang/djhsjzg/
单瘫	zhengzhuang/dt/
单腿半蹲痛	zhengzhuang/dtbdt/
单项ALT升高	zhengzhuang/dxaltsg/
单眼失明	zhengzhuang/dysm/
单眼突然出现一过性黑蒙	zhengzhuang/dytrcxygxhm/
单眼眼前黑影	zhengzhuang/dyyqhy/
胆道闭锁	zhengzhuang/ddbs/
胆道梗阻	zhengzhuang/ddgz/
胆道蛔虫症	zhengzhuang/ddhcz/
胆道运动功能障碍	zhengzhuang/ddydgnza/
胆管断裂	zhengzhuang/dgdl/
胆管梗阻	zhengzhuang/dggz/
胆红素钙结石	zhengzhuang/dhsgjs/
胆红素升高	zhengzhuang/dhssg/
胆碱能危象	zhengzhuang/djnwx/
胆绞痛	zhengzhuang/djt/
胆结石	zhengzhuang/djs/
胆囊壁变薄	zhengzhuang/dnbbb/
胆囊壁纤维化	zhengzhuang/dnbxwh/
胆囊触痛征	zhengzhuang/dnctz/
胆囊的超敏反应	zhengzhuang/dndcmfy/
胆囊积脓	zhengzhuang/dnjn/
胆囊积水	zhengzhuang/dnjs/
胆囊结石	zhengzhuang/dnjs_607/
胆囊收缩功能不良	zhengzhuang/dnssgnbl/
胆囊体积缩小	zhengzhuang/dntjsx/
胆囊运动障碍	zhengzhuang/dnydza/
胆囊增大	zhengzhuang/dnzd/
胆心综合征	zhengzhuang/dxzhz/
胆汁返流	zhengzhuang/dzfl/
胆汁排泄受阻	zhengzhuang/dzpxsz/
胆汁性肝硬化	zhengzhuang/dzxgyh/
胆汁淤滞	zhengzhuang/dzyz/
胆汁潴留	zhengzhuang/dzzl/
胆总管结石	zhengzhuang/dzgjs/
蛋氨酸吸收不良综合征	zhengzhuang/dasxsblzhz/
蛋白尿	zhengzhuang/dbn/
氮负平衡	zhengzhuang/dfph/
氮质血症	zhengzhuang/dzxz/
导水管周围受损	zhengzhuang/dsgzwss/
倒地笑	zhengzhuang/ddx/
倒睫	zhengzhuang/dj/
盗汗	zhengzhuang/dh_626/
等渗尿	zhengzhuang/dsn/
低补体血症	zhengzhuang/dbtxz/
低蛋白血症	zhengzhuang/ddbxz/
低分子蛋白尿	zhengzhuang/dfzdbn/
低钙血症	zhengzhuang/dgxz/
低枸橼酸尿	zhengzhuang/dgysn/
低钾血症	zhengzhuang/djxz/
低磷血症	zhengzhuang/dlxz/
低颅压综合征	zhengzhuang/dlyzhz/
低氯性碱中毒	zhengzhuang/dlxjzd/
低镁血症	zhengzhuang/dmxz/
低钠血症	zhengzhuang/dnxz/
低热	zhengzhuang/dr/
低热消疲	zhengzhuang/drxp/
低射血分数	zhengzhuang/dsxfs/
低位小肠梗阻	zhengzhuang/dwxcgz/
低位腰痛	zhengzhuang/dwyt/
低温性昏迷	zhengzhuang/dwxhm/
低血钾	zhengzhuang/dxj/
低血磷	zhengzhuang/dxl/
低血容量休克	zhengzhuang/dxrlxk/
低血糖惊厥	zhengzhuang/dxtjj/
低血糖性低温症	zhengzhuang/dxtxdwz/
低血糖性昏迷	zhengzhuang/dxtxhm/
低血糖症	zhengzhuang/dxtz/
低血压	zhengzhuang/dxy/
低氧血症	zhengzhuang/dyxz/
滴状角膜	zhengzhuang/dzjm/
骶部可有皮赘，形成尾巴	zhengzhuang/dbkypz_xcwb/
骶骨处持续性疼痛	zhengzhuang/dgccxxtt/
骶骨发育不良	zhengzhuang/dgfybl/
骶骨裂	zhengzhuang/dgl/
骶骨囊肿	zhengzhuang/dgnz/
骶髂部剧烈疼痛	zhengzhuang/dqbjltt/
骶髂关节疼痛	zhengzhuang/dqgjtt/
骶尾部窦道形成	zhengzhuang/dwbddxc/
骶尾部急性脓肿	zhengzhuang/dwbjxnz/
骶尾椎融合	zhengzhuang/dwzrh/
骶椎腰化	zhengzhuang/dzyh/
地图样骨缺损	zhengzhuang/dtygqs/
第1跖趾关节疼痛和肿大	zhengzhuang/d1zzgjtthzd/
第２肋软骨痛	zhengzhuang/d_lrgt/
第3腰椎横突的深部有明显压痛	zhengzhuang/d3yzhtdsbymxyt/
第5指短小弯曲	zhengzhuang/d5zdxwq/
第二性征改变	zhengzhuang/dexzgb/
第三心音奔马律	zhengzhuang/dsxybml/
第一心音亢进	zhengzhuang/dyxykj/
癫痫伴发的神经症	zhengzhuang/dxbfdsjz/
癫痫的单纯部分性发作	zhengzhuang/dxddcbfxfz/
癫痫的复杂部分性发作	zhengzhuang/dxdfzbfxfz/
癫痫的全身强直-阵挛发作	zhengzhuang/dxdqsqz_zlfz/
癫痫的失神发作	zhengzhuang/dxdssfz/
癫痫的植物神经性发作	zhengzhuang/dxdzwsjxfz/
癫痫和癫痫样发作	zhengzhuang/dxhdxyfz/
癫痫性人格改变	zhengzhuang/dxxrggb/
癫痫性头痛	zhengzhuang/dxxtt/
点头征	zhengzhuang/dtz/
点状出血	zhengzhuang/dzcx/
点状痤疮	zhengzhuang/dzcc/
碘甲亢	zhengzhuang/djk/
电击样剧痛	zhengzhuang/djyjt/
电击样痛或刺痛的头痛	zhengzhuang/djythctdtt/
电机械分离现象	zhengzhuang/djxflxx/
电生理异常	zhengzhuang/dslyc/
淀粉样变性	zhengzhuang/dfybx/
淀粉样蛋白沉积	zhengzhuang/dfydbcj/
跌倒发作	zhengzhuang/ddfz/
蝶鞍变形	zhengzhuang/dabx/
蝶鞍空泡	zhengzhuang/dakp/
蝶形骨折	zhengzhuang/dxgz/
定位神经体征	zhengzhuang/dwsjtz/
定位体征	zhengzhuang/dwtz/
定向力障碍	zhengzhuang/dxlza/
冬春季的慢性咳嗽咳痰和喘息	zhengzhuang/dcjdmxkskthcx/
冬季皮肤瘙痒	zhengzhuang/djpfsy/
冬天脚冷	zhengzhuang/dtjl/
动静脉短路现象	zhengzhuang/djmdlxx/
动脉呈多处伸长扭曲状	zhengzhuang/dmcdcscnqz/
动脉出血	zhengzhuang/dmcx/
动脉导管未闭	zhengzhuang/dmdgwb/
动脉盗血	zhengzhuang/dmdx/
动脉血氧饱和度降低	zhengzhuang/dmxybhdjd/
动脉造影异常	zhengzhuang/dmzyyc/
动脉粥样硬化	zhengzhuang/dmzyyh/
动眼神经麻痹	zhengzhuang/dysjmb/
动眼危象	zhengzhuang/dywx/
动作样壁	zhengzhuang/dzyb/
冻疮	zhengzhuang/dc/
冻结肩	zhengzhuang/djj/
豆纹动脉闭塞	zhengzhuang/dwdmbs/
痘疤	zhengzhuang/db/
痘疮	zhengzhuang/dc_718/
窦道相	zhengzhuang/ddx_719/
窦房传导阻滞	zhengzhuang/dfcdzz/
窦房结病变	zhengzhuang/dfjbb/
窦性停搏	zhengzhuang/dxtb/
毒品依赖	zhengzhuang/dpyl/
毒物致肝损害	zhengzhuang/dwzgsh/
毒性表现	zhengzhuang/dxbx/
毒血症	zhengzhuang/dxz_726/
毒蕈碱样症状	zhengzhuang/dxjyzz/
读小字和辨色困难	zhengzhuang/dxzhbskn/
肚脐疼	zhengzhuang/dqt/
肚脐痒	zhengzhuang/dqy/
端坐呼吸	zhengzhuang/dzhx/
短颈	zhengzhuang/dj_732/
短缩舌	zhengzhuang/dss/
短头畸形	zhengzhuang/dtjx/
短暂性眩晕	zhengzhuang/dzxxy/
断毛癖	zhengzhuang/dmp/
断续的肌收缩	zhengzhuang/dxdjss/
对铋盐过敏	zhengzhuang/dbygm/
对侧肢体偏瘫	zhengzhuang/dcztpt/
对称性肌无力	zhengzhuang/dcxjwl/
对多脂饮食不能耐受	zhengzhuang/ddzysbnns/
对光反射迟钝	zhengzhuang/dgfscd/
对光反应消失	zhengzhuang/dgfyxs/
对红绿颜色分辨不清	zhengzhuang/dhlysfbbq/
对女性物品的非正常爱好	zhengzhuang/dnxwpdfzcah/
对生活丧失兴趣	zhengzhuang/dshssxq/
对声音敏感	zhengzhuang/dsymg/
对听、视、触觉等刺激反应过度	zhengzhuang/dt_s_cjdcjfygd/
蹲下起来后眼前发黑	zhengzhuang/dxqlhyqfh/
钝痛	zhengzhuang/dt_750/
多发性结节	zhengzhuang/dfxjj/
多发性神经炎	zhengzhuang/dfxsjy/
多发性针尖样瘀点	zhengzhuang/dfxzjyyd/
多根肋骨骨折	zhengzhuang/dglggz/
多汗且臭味较浓	zhengzhuang/dhqcwjn/
多汗症	zhengzhuang/dhz/
多克隆型冷球蛋白血症	zhengzhuang/dklxlqdbxz/
多梦	zhengzhuang/dm_758/
多囊卵巢	zhengzhuang/dnlc/
多尿	zhengzhuang/dn/
多形红斑样皮疹	zhengzhuang/dxhbypz/
多血质	zhengzhuang/dxz_762/
多疑	zhengzhuang/dy/
多饮	zhengzhuang/dy_764/
多指（趾）畸形	zhengzhuang/dz_z_jx/
额横纹增深	zhengzhuang/ehwzs/
肝掌	zhengzhuang/gz/
“E”字征	zhengzhuang/_e_zz/
21-羟化酶缺陷症	zhengzhuang/21_qhmqxz/
额部白斑	zhengzhuang/ebbb/
额部疼痛	zhengzhuang/ebtt/
额部肿块	zhengzhuang/ebzk/
额区感觉减退	zhengzhuang/eqgjjt/
额头长痘	zhengzhuang/etcd/
额头皱纹突然增加	zhengzhuang/etzwtrzj/
额叶癫痫岛盖发作	zhengzhuang/eydxdgfz/
额叶癫痫的“击剑姿势”	zhengzhuang/eydxd_jjzs_/
额叶癫痫的扣带回发作	zhengzhuang/eydxdkdhfz/
额叶癫痫的眶额区发作	zhengzhuang/eydxdkeqfz/
额叶癫痫的前额极区发作	zhengzhuang/eydxdqejqfz/
额叶癫痫的运动皮质发作	zhengzhuang/eydxdydpzfz/
呃逆	zhengzhuang/en/
恶病性痤疮	zhengzhuang/ebxcc/
恶病质	zhengzhuang/ebz/
恶病质面容	zhengzhuang/ebzmr/
恶臭便	zhengzhuang/ecb/
恶寒	zhengzhuang/eh/
恶露	zhengzhuang/el/
恶食凉物	zhengzhuang/eslw/
恶食酸物	zhengzhuang/essw/
恶息、多泡味的白色粪便	zhengzhuang/ex_dpwdbsfb/
恶心	zhengzhuang/ex/
恶心与呕吐	zhengzhuang/exyot/
恶性贫血	zhengzhuang/expx/
恶性胸水	zhengzhuang/exxs/
腭部穿孔	zhengzhuang/ebck/
腭部可见小出血点	zhengzhuang/ebkjxcxd/
腭部有黑色焦痂	zhengzhuang/ebyhsjj/
腭舌咽呼吸肌呈对称性弛缓性轻瘫	zhengzhuang/esyhxjcdcxchxqt/
腭异常	zhengzhuang/eyc/
噩梦	zhengzhuang/em/
儿茶酚胺分泌过量	zhengzhuang/ecfafmgl/
儿童不敢平卧睡觉	zhengzhuang/etbgpwsj/
儿童抽动症	zhengzhuang/etcdz/
儿童大便失禁	zhengzhuang/etdbsj/
儿童反复骨折	zhengzhuang/etffgz/
儿童骨缺损	zhengzhuang/etgqs/
儿童精神运动发育异常	zhengzhuang/etjsydfyyc/
儿童恐怖障碍	zhengzhuang/etkbza/
儿童恐怖症	zhengzhuang/etkbz/
儿童髋部疼痛	zhengzhuang/etkbtt/
儿童离别焦虑	zhengzhuang/etlbjl/
儿童联想和情感障碍	zhengzhuang/etlxhqgza/
儿童尿床	zhengzhuang/etnc/
儿童偏食	zhengzhuang/etps/
儿童偏头痛	zhengzhuang/etptt/
儿童期过度生长	zhengzhuang/etqgdsc/
儿童期消化性溃疡	zhengzhuang/etqxhxky/
儿童头痛	zhengzhuang/ettt/
儿童退缩行为	zhengzhuang/ettsxw/
儿童行动迟缓	zhengzhuang/etxdch/
儿童行为孤僻	zhengzhuang/etxwgp/
儿童型肌张力障碍	zhengzhuang/etxjzlza/
儿童性别偏差	zhengzhuang/etxbpc/
耳、鼻、软骨变成蓝色	zhengzhuang/e_b_rgbcls/
耳垂长痘	zhengzhuang/eccd/
耳垂过大	zhengzhuang/ecgd/
耳垂里有硬疙瘩	zhengzhuang/eclyygd/
耳垂缺损	zhengzhuang/ecqs/
耳垂小	zhengzhuang/ecx/
耳垂粘连	zhengzhuang/eczl/
耳道堵塞	zhengzhuang/edds/
耳道划伤	zhengzhuang/edhs/
耳道流脓	zhengzhuang/edln/
耳道流血	zhengzhuang/edlx/
耳道异物	zhengzhuang/edyw/
耳顶线以下至发际处痛觉过敏或减退	zhengzhuang/edxyxzfjctjgmhjt/
耳冻伤	zhengzhuang/eds/
耳堵	zhengzhuang/ed/
耳朵位置低	zhengzhuang/edwzd/
耳根部疼痛	zhengzhuang/egbtt/
耳骨外翻	zhengzhuang/egwf/
耳鼓膜穿孔	zhengzhuang/egmck/
耳鼓膜破裂	zhengzhuang/egmpl/
耳郭突出	zhengzhuang/egtc/
耳后红斑	zhengzhuang/ehhb/
耳后淋巴结肿大	zhengzhuang/ehlbjzd/
耳后乳突水肿	zhengzhuang/ehrtsz/
耳后疼痛	zhengzhuang/ehtt/
耳壳的干性坏死	zhengzhuang/ekdgxhs/
耳孔处长出的肿物	zhengzhuang/ekcccdzw/
耳孔处肿物	zhengzhuang/ekczw/
耳廓变大	zhengzhuang/ekbd/
耳廓擦伤	zhengzhuang/ekcs/
耳廓耳道撕裂伤	zhengzhuang/ekedsls/
耳廓放射性痛	zhengzhuang/ekfsxt/
耳廓腹侧面局限性囊肿	zhengzhuang/ekfcmjxxnz/
耳廓红肿	zhengzhuang/ekhz/
耳廓痛	zhengzhuang/ekt/
耳廓癣	zhengzhuang/ekx/
耳流脓	zhengzhuang/eln/
耳聋	zhengzhuang/el_862/
耳漏	zhengzhuang/el_863/
耳轮发育不全	zhengzhuang/elfybq/
耳闷	zhengzhuang/em_865/
耳鸣	zhengzhuang/em_866/
耳内闭塞感	zhengzhuang/enbsg/
耳内发胀	zhengzhuang/enfz/
耳内流脓	zhengzhuang/enln/
耳内疼痛	zhengzhuang/entt/
耳前淋巴结肿大	zhengzhuang/eqlbjzd/
耳前庭功能受损	zhengzhuang/eqtgnss/
耳前庭听觉失衡	zhengzhuang/eqttjsh/
耳屎多	zhengzhuang/esd/
耳痛	zhengzhuang/et/
耳围凹陷	zhengzhuang/ewax/
耳蜗性耳聋	zhengzhuang/ewxel/
耳下区的韧实肿块	zhengzhuang/exqdrszk/
耳痒	zhengzhuang/ey/
耳溢液	zhengzhuang/eyy/
耳硬化症	zhengzhuang/eyhz/
耳源性破伤风	zhengzhuang/eyxpsf/
耳源性眩晕	zhengzhuang/eyxxy/
二尖瓣脱垂	zhengzhuang/ejbtc/
二碱基氨基酸尿症	zhengzhuang/ejjajsnz/
二羧基氨基酸尿	zhengzhuang/esjajsn/
发绀	zhengzhuang/fg/
发烧	zhengzhuang/fs/
发热伴出血	zhengzhuang/frbcx/
发热伴关节肿痛	zhengzhuang/frbgjzt/
发热伴寒战	zhengzhuang/frbhz/
发热伴咳嗽、咯痰、胸痛	zhengzhuang/frbks_kt_xt/
发热伴淋巴结肿大、并伴触痛	zhengzhuang/frblbjzd_bbct/
发热伴尿频、尿急、尿痛、腰疼	zhengzhuang/frbnp_nj_nt_yt/
发热伴眼睛充血	zhengzhuang/frbyjcx/
发热伴有腹痛、腹泻、恶心、呕吐	zhengzhuang/frbyft_fx_ex_ot/
发热伴有皮疹	zhengzhuang/frbypz/
发炎	zhengzhuang/fy/
发音改变	zhengzhuang/fygb/
发音障碍	zhengzhuang/fyza/
发育性骨盆异常	zhengzhuang/fyxgpyc/
发育性畸形	zhengzhuang/fyxjx/
发作后精神障碍	zhengzhuang/fzhjsza/
发作时精神障碍	zhengzhuang/fzsjsza/
发作性不自主运动	zhengzhuang/fzxbzzyd/
发作性咳嗽	zhengzhuang/fzxks/
发作性傻笑	zhengzhuang/fzxsx/
发作性嗜睡和食欲亢进	zhengzhuang/fzxsshsykj/
发作性睡眠	zhengzhuang/fzxsm/
发作性眩晕	zhengzhuang/fzxxy/
乏力	zhengzhuang/fl/
帆状胎盘	zhengzhuang/fztp/
翻身困难	zhengzhuang/fskn/
烦热	zhengzhuang/fr/
烦躁不安	zhengzhuang/fzba/
反拗危象	zhengzhuang/fawx/
反复鼻出血	zhengzhuang/ffbcx/
反复不愈的感染	zhengzhuang/ffbydgr/
反复抽搐	zhengzhuang/ffcc/
反复出血	zhengzhuang/ffcx/
反复发烧	zhengzhuang/fffs/
反复发作的带状疱疹	zhengzhuang/fffzddzpz/
反复发作性头痛	zhengzhuang/fffzxtt/
反复发作抑郁症	zhengzhuang/fffzyyz/
反复发作右肺感染	zhengzhuang/fffzyfgr/
反复肺不张	zhengzhuang/fffbz/
反复肺炎	zhengzhuang/fffy/
反复感冒	zhengzhuang/ffgm/
反复感染	zhengzhuang/ffgr/
反复高热	zhengzhuang/ffgr_930/
反复呕血	zhengzhuang/ffox/
反复上呼吸道感染	zhengzhuang/ffshxdgr/
反复生殖器溃疡	zhengzhuang/ffszqky/
反复舔吮口唇	zhengzhuang/fftskc/
反射弧中断	zhengzhuang/fshzd/
反射性呕吐	zhengzhuang/fsxot/
反射性腰痛	zhengzhuang/fsxyt/
反胃	zhengzhuang/fw/
反向搏动	zhengzhuang/fxbd/
反应迟钝	zhengzhuang/fycd/
反应性细胞改变	zhengzhuang/fyxxbgb/
泛恶欲吐	zhengzhuang/feyt/
泛发性红色斑块	zhengzhuang/ffxhsbk/
饭后口淡	zhengzhuang/fhkd/
饭后困倦	zhengzhuang/fhkj/
饭后心悸	zhengzhuang/fhxj/
饭后心跳加快	zhengzhuang/fhxtjk/
方肩畸形	zhengzhuang/fjjx/
房间隔缺损	zhengzhuang/fjgqs/
房内传导阻滞	zhengzhuang/fncdzz/
房室传导阻滞	zhengzhuang/fscdzz/
房室分离	zhengzhuang/fsfl/
房室管畸形	zhengzhuang/fsgjx/
房性逸搏心律加速	zhengzhuang/fxybxljs/
房性早搏	zhengzhuang/fxzb/
放屁过臭	zhengzhuang/fpgc/
放屁频频	zhengzhuang/fppp/
放射后的臂丛神经和腰骶丛损伤	zhengzhuang/fshdbcsjhydcss/
放射性疼痛	zhengzhuang/fsxtt/
非凹陷黏液水肿	zhengzhuang/faxnysz/
非玻璃体的病变眼前飞蚊	zhengzhuang/fbltdbbyqfw/
非对称性关节痛	zhengzhuang/fdcxgjt/
非对称性紧张性颈反射	zhengzhuang/fdcxjzxjfs/
非感染性发热	zhengzhuang/fgrxfr/
非怀孕的下腹增大	zhengzhuang/fhydxfzd/
非血性腹水	zhengzhuang/fxxfs/
非依赖性物质所致的精神障碍	zhengzhuang/fylxwzszdjsza/
肥达反应阳性	zhengzhuang/fdfyyx/
肥大结节纤维组织增生	zhengzhuang/fdjjxwzzzs/
肥厚瘢痕	zhengzhuang/fhbh/
肥胖并痛性结节或脂肪块	zhengzhuang/fpbtxjjhzfk/
肥胖前期	zhengzhuang/fpqq/
肥胖纹	zhengzhuang/fpw/
肥胖性低通气	zhengzhuang/fpxdtq/
肥胖性水肿	zhengzhuang/fpxsz/
废用性弱视	zhengzhuang/fyxrs/
肺癌胸水	zhengzhuang/faxs/
肺不张	zhengzhuang/fbz/
肺部出血	zhengzhuang/fbcx/
肺部感染	zhengzhuang/fbgr/
肺部化脓性感染	zhengzhuang/fbhnxgr/
肺部或支气管周围可呈现纹理增粗及浸润现象	zhengzhuang/fbhzqgzwkcxwlzcjjrxx/
肺部可闻及干湿啰音及哮鸣音	zhengzhuang/fbkwjgslyjxmy/
肺部啰音	zhengzhuang/fbly/
肺部肿块	zhengzhuang/fbzk/
肺部转移	zhengzhuang/fbzy/
肺动静脉瘘	zhengzhuang/fdjml/
肺动脉瓣区可听到喷射音	zhengzhuang/fdmbqktdpsy/
肺动脉瓣狭窄杂音	zhengzhuang/fdmbxzzy/
肺动脉闭锁	zhengzhuang/fdmbs/
肺动脉狭窄	zhengzhuang/fdmxz/
肺动脉楔压（PCWP）降低	zhengzhuang/fdmxy_pcwp_jd/
肺动脉杂音	zhengzhuang/fdmzy/
肺过度充气	zhengzhuang/fgdcq/
肺含水量增加	zhengzhuang/fhslzj/
肺火	zhengzhuang/fh/
肺积水	zhengzhuang/fjs/
肺间质纤维化	zhengzhuang/fjzxwh/
肺门阴影增多	zhengzhuang/fmyyzd/
肺门增宽	zhengzhuang/fmzk/
肺弥散功能障碍	zhengzhuang/fmsgnza/
肺内病变	zhengzhuang/fnbb/
肺内空洞	zhengzhuang/fnkd/
肺内圆形实质性或囊性肿块	zhengzhuang/fnyxszxhnxzk/
肺泡出血	zhengzhuang/fpcx/
肺泡灌洗液可见大量无定形的碎片	zhengzhuang/fpgxykjdlwdxdsp/
肺泡炎症	zhengzhuang/fpyz/
肺气压伤	zhengzhuang/fqys/
肺弃血	zhengzhuang/fqx/
肺容量减小	zhengzhuang/frljx/
肺实变	zhengzhuang/fsb/
肺受累	zhengzhuang/fsl/
肺栓塞	zhengzhuang/fss/
肺通气一血流比例失调	zhengzhuang/ftqyxlblsd/
肺外症状	zhengzhuang/fwzz/
肺纹理减少	zhengzhuang/fwljs/
肺纹理增粗	zhengzhuang/fwlzc/
肺纹理增多	zhengzhuang/fwlzd/
肺下叶周围呈节段性或大叶性模糊阴影	zhengzhuang/fxyzwcjdxhdyxmhyy/
肺纤维化	zhengzhuang/fxwh/
肺性肥大	zhengzhuang/fxfd/
肺血流量很多	zhengzhuang/fxllhd/
肺血流量很少	zhengzhuang/fxllhs/
肺血增多	zhengzhuang/fxzd/
肺阴虚	zhengzhuang/fyx/
肺淤血	zhengzhuang/fyx_1026/
肺源性呼吸困难	zhengzhuang/fyxhxkn/
肺源性心脏衰竭	zhengzhuang/fyxxzsj/
痱疹样皮疹	zhengzhuang/fzypz/
分离性恍惚状态和附体状态	zhengzhuang/flxhhzthftzt/
分离性漫游症	zhengzhuang/flxmyz/
分离性身份障碍	zhengzhuang/flxsfza/
分离性遗忘	zhengzhuang/flxyw/
分裂型人格障碍	zhengzhuang/flxrgza/
分泌性腹泻	zhengzhuang/fmxfx/
分娩后甲状腺肿大	zhengzhuang/fmhjzxzd/
粉红色泡沫痰	zhengzhuang/fhspmt/
粉红色泡沫样痰	zhengzhuang/fhspmyt/
粉碎性骨折	zhengzhuang/fsxgz/
粪便带绿色	zhengzhuang/fbdls/
粪便黑色并带有血液	zhengzhuang/fbhsbdyxy/
粪便量多	zhengzhuang/fbld/
粪便量少	zhengzhuang/fbls/
粪便脓血	zhengzhuang/fbnx/
粪便排出过程异常	zhengzhuang/fbpcgcyc/
粪便嵌塞	zhengzhuang/fbqs/
粪便硬结如羊粪状	zhengzhuang/fbyjryfz/
粪便中查见虫卵或妊娠节片	zhengzhuang/fbzcjclhrsjp/
粪便中发现白色节片	zhengzhuang/fbzfxbsjp/
粪便中见到褐红色果实皮或毛发	zhengzhuang/fbzjdhhsgsphmf/
粪便中排出的粪胆原增加	zhengzhuang/fbzpcdfdyzj/
粪内或直肠乙状结肠黏膜活检找到血吸虫卵	zhengzhuang/fnhzcyzjcnmhjzdxxcl/
粪样呕吐物	zhengzhuang/fyotw/
粪柱变形变细	zhengzhuang/fzbxbx/
风寒湿痹	zhengzhuang/fhsb/
风丘疹	zhengzhuang/fqz/
风盛血燥	zhengzhuang/fsxz/
风湿性多发性肌痛症	zhengzhuang/fsxdfxjtz/
风湿性血管炎	zhengzhuang/fsxxgy/
风团	zhengzhuang/ft/
蜂窝肺	zhengzhuang/fwf/
蜂窝组织炎	zhengzhuang/fwzzy/
肤色赤红	zhengzhuang/fsch/
伏脉	zhengzhuang/fm/
浮脉	zhengzhuang/fm_1065/
匐行疹	zhengzhuang/fxz/
附睾结石	zhengzhuang/fgjs/
附睾囊肿	zhengzhuang/fgnz/
附睾肿大发硬	zhengzhuang/fgzdfy/
复聪现象	zhengzhuang/fcxx/
复合性溃疡	zhengzhuang/fhxky/
复视	zhengzhuang/fs_1072/
复听	zhengzhuang/ft_1073/
复杂性尿路感染	zhengzhuang/fzxnlgr/
复杂性醉酒	zhengzhuang/fzxzj/
副耳	zhengzhuang/fe/
腹壁不自主轴动	zhengzhuang/fbbzzzd/
腹壁反射减弱或消失	zhengzhuang/fbfsjrhxs/
腹壁广泛性钙质沉着	zhengzhuang/fbgfxgzcz/
腹壁红斑	zhengzhuang/fbhb/
腹壁静脉怒张	zhengzhuang/fbjmnz/
腹壁切口处有肿物突出	zhengzhuang/fbqkcyzwtc/
腹壁外侧包块 ，有固定压痛	zhengzhuang/fbwcbk_ygdyt/
腹部“气串样”肿块	zhengzhuang/fb_qcy_zk/
腹部“柔韧感”体征	zhengzhuang/fb_rrg_tz/
腹部凹陷呈舟状	zhengzhuang/fbaxczz/
腹部不适	zhengzhuang/fbbs/
腹部可触及巨大柔软肿物	zhengzhuang/fbkcjjdrrzw/
腹部皮肤出现白纹、粉红色或紫纹	zhengzhuang/fbpfcxbw_fhshzw/
腹部皮肤梅干样皱纹	zhengzhuang/fbpfmgyzw/
腹部伤口流出粪便样物	zhengzhuang/fbsklcfbyw/
腹部型肥胖	zhengzhuang/fbxfp/
腹部血管杂音	zhengzhuang/fbxgzy/
腹部压痛	zhengzhuang/fbyt/
腹部有局部或广泛触痛、反跳痛	zhengzhuang/fbyjbhgfct_ftt/
腹部中线处肿块	zhengzhuang/fbzxczk/
腹部肿块	zhengzhuang/fbzk_1097/
腹部逐渐胀大	zhengzhuang/fbzjzd/
腹股沟处或闭孔处肿胀	zhengzhuang/fggchbkczz/
腹股沟淋巴结肿大	zhengzhuang/fgglbjzd/
腹股沟区可复性肿块	zhengzhuang/fggqkfxzk/
腹股沟疼痛	zhengzhuang/fggtt/
腹股沟痒	zhengzhuang/fggy/
腹肌肌肉抽搐	zhengzhuang/fjjrcc/
腹肌紧张	zhengzhuang/fjjz/
腹肌强直	zhengzhuang/fjqz/
腹肌严重发育不良	zhengzhuang/fjyzfybl/
腹满	zhengzhuang/fm_1108/
腹鸣	zhengzhuang/fm_1109/
腹膜刺激征	zhengzhuang/fmcjz/
腹膜后纤维化	zhengzhuang/fmhxwh/
腹膜炎	zhengzhuang/fmy/
腹内压升高	zhengzhuang/fnysg/
腹腔出血	zhengzhuang/fqcx/
腹腔感染	zhengzhuang/fqgr/
腹腔积血	zhengzhuang/fqjx/
腹腔积液	zhengzhuang/fqjy/
腹腔种植	zhengzhuang/fqzz/
腹式反常呼吸	zhengzhuang/fsfchx/
腹水	zhengzhuang/fs_1120/
腹痛	zhengzhuang/ft_1121/
腹痛，发热及黄疸	zhengzhuang/ft_frjhd/
腹痛伴便血	zhengzhuang/ftbbx/
腹痛伴恶心、呕吐	zhengzhuang/ftbex_ot/
腹痛伴腹泻	zhengzhuang/ftbfx/
腹痛伴黄疸	zhengzhuang/ftbhd/
腹痛伴休克	zhengzhuang/ftbxk/
腹痛伴血尿	zhengzhuang/ftbxn/
腹围增大	zhengzhuang/fwzd/
腹泻	zhengzhuang/fx/
腹泻为水样带黏液恶臭无脓血	zhengzhuang/fxwsydnyecwnx/
腹泻与便秘交替	zhengzhuang/fxybmjt/
腹胀	zhengzhuang/fz/
腹直肌触及边界不清的固定包块	zhengzhuang/fzjcjbjbqdgdbk/
胁部肿胀	zhengzhuang/xbzz/
钙沉积	zhengzhuang/gcj/
钙化	zhengzhuang/gh/
钙化影	zhengzhuang/ghy/
钙化灶	zhengzhuang/ghz/
钙离子内流	zhengzhuang/glznl/
干咳	zhengzhuang/gk/
干啰音	zhengzhuang/gly/
干胁痛	zhengzhuang/gxt/
干性坏疽	zhengzhuang/gxhj/
干性脚气	zhengzhuang/gxjq/
干性咳嗽	zhengzhuang/gxks/
干性皮肤	zhengzhuang/gxpf/
干性脂溢	zhengzhuang/gxzy/
干燥斑	zhengzhuang/gzb/
肝被膜紧张	zhengzhuang/gbmjz/
肝被膜血肿破裂	zhengzhuang/gbmxzpl/
肝病面容	zhengzhuang/gbmr/
肝病容	zhengzhuang/gbr/
肝部疼痛	zhengzhuang/gbtt/
肝臭	zhengzhuang/gc/
肝大而硬	zhengzhuang/gdey/
肝淀粉样变性	zhengzhuang/gdfybx/
肝豆状核变性	zhengzhuang/gdzhbx/
肝窦扩张	zhengzhuang/gdkz/
肝腹水	zhengzhuang/gfs/
肝功检查胆红素及转氨酶常增高	zhengzhuang/ggjcdhsjzamczg/
肝功能不全	zhengzhuang/ggnbq/
肝功能受损	zhengzhuang/ggnss/
肝功能衰竭	zhengzhuang/ggnsj/
肝功能异常	zhengzhuang/ggnyc/
肝昏迷	zhengzhuang/ghm/
肝火	zhengzhuang/gh_1167/
肝积水	zhengzhuang/gjs/
肝-颈静脉回流征阳性	zhengzhuang/g_jjmhlzyx/
肝静脉病变	zhengzhuang/gjmbb/
肝静脉回流障碍	zhengzhuang/gjmhlza/
肝内HDAg仅一过性阳性	zhengzhuang/gnhdagjygxyx/
肝内胆管结石	zhengzhuang/gndgjs/
肝内钙化	zhengzhuang/gngh/
肝内管梗阻	zhengzhuang/gnggz/
肝内形成嗜酸性肉芽肿	zhengzhuang/gnxcssxryz/
肝内淤胆	zhengzhuang/gnyd/
肝脾肿大	zhengzhuang/gpzd/
肝气不足	zhengzhuang/gqbz/
肝气犯肺	zhengzhuang/gqff/
肝气犯脾	zhengzhuang/gqfp/
肝气犯胃	zhengzhuang/gqfw/
肝气郁节	zhengzhuang/gqyj/
肝气郁结	zhengzhuang/gqyj_1184/
肝区摩擦音	zhengzhuang/gqmcy/
肝区血管杂音	zhengzhuang/gqxgzy/
肝肾综合征	zhengzhuang/gszhz/
肝衰竭	zhengzhuang/gsj/
肝缩小	zhengzhuang/gsx/
肝糖异生增加	zhengzhuang/gtyszj/
肝外胆管结石	zhengzhuang/gwdgjs/
肝细胞坏死	zhengzhuang/gxbhs/
肝细胞内脂肪堆积过多	zhengzhuang/gxbnzfdjgd/
肝细胞索支架塌陷	zhengzhuang/gxbszjtx/
肝细胞脂肪性变	zhengzhuang/gxbzfxb/
肝下垂	zhengzhuang/gxc/
肝纤维化	zhengzhuang/gxwh/
肝星状细胞增生	zhengzhuang/gxzxbzs/
肝叶萎缩	zhengzhuang/gyws/
肝阴虚	zhengzhuang/gyx/
肝淤血	zhengzhuang/gyx_1201/
肝郁气滞	zhengzhuang/gyqz/
肝源性水肿	zhengzhuang/gyxsz/
肝脏病变弥漫	zhengzhuang/gzbbmm/
肝脏轻度脂肪变性	zhengzhuang/gzqdzfbx/
肝脏肿大	zhengzhuang/gzzd/
肝脂肪变	zhengzhuang/gzfb/
肝质地硬	zhengzhuang/gzdy/
肝肿大	zhengzhuang/gzd/
肝转移	zhengzhuang/gzy/
肝浊音界缩小或消失	zhengzhuang/gzyjsxhxs/
感觉倒错	zhengzhuang/gjdc/
感觉分离	zhengzhuang/gjfl/
感觉过度	zhengzhuang/gjgd/
感觉过敏	zhengzhuang/gjgm/
感觉性共济失调	zhengzhuang/gjxgjsd/
感觉性共济失调步态	zhengzhuang/gjxgjsdbt/
感觉障碍	zhengzhuang/gjza/
感染性鼻炎	zhengzhuang/grxby/
感染性发热	zhengzhuang/grxfr/
感染性赘生物	zhengzhuang/grxzsw/
感染诱发昏迷	zhengzhuang/gryfhm/
肛管反射消失	zhengzhuang/ggfsxs/
肛管括约肌横断	zhengzhuang/ggkyjhd/
肛管息肉	zhengzhuang/ggxr/
肛管狭窄	zhengzhuang/ggxz/
肛裂	zhengzhuang/gl/
肛裂溃疡	zhengzhuang/glky/
肛裂三联征	zhengzhuang/glslz/
肛门病变	zhengzhuang/gmbb/
肛门短时间阵发性钝痛	zhengzhuang/gmdsjzfxdt/
肛门反射减弱或消失	zhengzhuang/gmfsjrhxs/
肛门会阴区潮湿不洁	zhengzhuang/gmhyqcsbj/
肛门或肛管窄小	zhengzhuang/gmhggzx/
肛门畸形	zhengzhuang/gmjx/
肛门剧痛	zhengzhuang/gmjt/
肛门括约肌松弛	zhengzhuang/gmkyjsc/
肛门湿疹瘙痒	zhengzhuang/gmszsy/
肛门松弛	zhengzhuang/gmsc/
肛门疼痛	zhengzhuang/gmtt/
肛门外翻	zhengzhuang/gmwf/
肛门外括约肌断裂	zhengzhuang/gmwkyjdl/
肛门夜间奇痒	zhengzhuang/gmyjqy/
肛门有黑色肿块脱出	zhengzhuang/gmyhszktc/
肛门直肠畸形	zhengzhuang/gmzcjx/
肛门坠胀	zhengzhuang/gmzz/
肛内分泌物多	zhengzhuang/gnfmwd/
肛内轻微隐痛坠胀或不适感	zhengzhuang/gnqwytzzhbsg/
肛旁脓肿	zhengzhuang/gpnz/
肛区为皮肤覆盖	zhengzhuang/gqwpffg/
肛乳头肥大	zhengzhuang/grtfd/
肛腺分泌减少	zhengzhuang/gxfmjs/
肛周囊肿	zhengzhuang/gznz/
肛周皮肤潮红	zhengzhuang/gzpfch/
肛周皮肤有湿疹	zhengzhuang/gzpfysz/
肛周软瘊	zhengzhuang/gzrh/
高氨血症	zhengzhuang/gaxz/
高草酸尿	zhengzhuang/gcsn/
高促胃泌素血症	zhengzhuang/gcwmsxz/
高代谢征群	zhengzhuang/gdxzq/
高度膨胀的毛细血管襻	zhengzhuang/gdpzdmxxgp/
高腭弓	zhengzhuang/geg/
高钙血症	zhengzhuang/ggxz_1263/
高睾酮血症	zhengzhuang/ggtxz/
高钾血症	zhengzhuang/gjxz/
高颅压综合征	zhengzhuang/glyzhz/
高镁血症	zhengzhuang/gmxz/
高钠血症	zhengzhuang/gnxz/
高尿酸血症	zhengzhuang/gnsxz/
高凝状态	zhengzhuang/gnzt/
高热	zhengzhuang/gr/
高热不退	zhengzhuang/grbt/
高热寒战	zhengzhuang/grhz/
高渗尿	zhengzhuang/gsn/
高渗性昏迷	zhengzhuang/gsxhm/
高耸而对称的T波	zhengzhuang/gsedcdtb/
高碳酸血症	zhengzhuang/gtsxz/
高通气	zhengzhuang/gtq/
高同型半胱氨酸血症	zhengzhuang/gtxbgasxz/
高位截瘫	zhengzhuang/gwjt/
高温性水肿	zhengzhuang/gwxsz/
高雄激素血症	zhengzhuang/gxjsxz/
高血氮	zhengzhuang/gxd/
高血钾	zhengzhuang/gxj/
高血压	zhengzhuang/gxy/
高血脂性血管损害	zhengzhuang/gxzxxgsh/
高眼压	zhengzhuang/gyy/
高原多血面容	zhengzhuang/gydxmr/
高粘滞综合征	zhengzhuang/gzzzhz/
睾丸触痛	zhengzhuang/gwct/
睾丸发育不全	zhengzhuang/gwfybq/
睾丸受浸润	zhengzhuang/gwsjr/
睾丸疼痛	zhengzhuang/gwtt/
睾丸微小	zhengzhuang/gwwx/
睾丸萎缩	zhengzhuang/gwws/
睾丸增大和变硬	zhengzhuang/gwzdhby/
睾丸胀痛	zhengzhuang/gwzt/
革兰阴性杆菌感染	zhengzhuang/glyxgjgr/
革脉	zhengzhuang/gm/
格子样变性	zhengzhuang/gzybx/
隔膜孔道狭小	zhengzhuang/gmkdxx/
膈肌缺损	zhengzhuang/gjqs/
膈麻痹	zhengzhuang/gmb/
膈膨升	zhengzhuang/gps/
膈穹窿变为扁平	zhengzhuang/gqlbwbp/
膈下感染	zhengzhuang/gxgr/
更年期肥胖	zhengzhuang/gnqfp/
更年期功血	zhengzhuang/gnqgx/
更年期抑郁	zhengzhuang/gnqyy/
梗噎	zhengzhuang/gy/
工作倦怠	zhengzhuang/gzjd/
弓形体感染	zhengzhuang/gxtgr/
弓形足	zhengzhuang/gxz/
弓状指	zhengzhuang/gzz/
公鸡步态	zhengzhuang/gjbt/
功能性头痛	zhengzhuang/gnxtt/
功能性震颤	zhengzhuang/gnxzc/
攻击行为	zhengzhuang/gjxw/
宫底及耻骨联合上方空虚	zhengzhuang/gdjcglhsfkx/
宫颈闭锁	zhengzhuang/gjbs/
宫颈肥大	zhengzhuang/gjfd/
宫颈举痛	zhengzhuang/gjjt/
宫颈糜烂	zhengzhuang/gjml/
宫颈囊肿	zhengzhuang/gjnz/
宫颈黏液脓性分泌物	zhengzhuang/gjnynxfmw/
宫颈前唇水肿	zhengzhuang/gjqcsz/
宫颈软	zhengzhuang/gjr/
宫颈水肿	zhengzhuang/gjsz/
宫颈粘连	zhengzhuang/gjzl/
宫颈粘液少	zhengzhuang/gjzys/
宫腔分离	zhengzhuang/gqfl/
宫腔积脓	zhengzhuang/gqjn/
宫腔积血	zhengzhuang/gqjx/
宫腔粘连	zhengzhuang/gqzl/
宫缩乏力	zhengzhuang/gsfl/
巩膜充血	zhengzhuang/gmcx/
巩膜出血	zhengzhuang/gmcx_1337/
巩膜穿孔	zhengzhuang/gmck/
巩膜黄染	zhengzhuang/gmhr/
巩膜水肿	zhengzhuang/gmsz/
巩膜外层炎	zhengzhuang/gmwcy/
巩膜小泡	zhengzhuang/gmxp/
汞毒性震颤	zhengzhuang/gdxzc/
共济失调	zhengzhuang/gjsd/
沟裂增宽	zhengzhuang/glzk/
钩骨附近的压痛	zhengzhuang/ggfjdyt/
钩回发作	zhengzhuang/ghfz/
钩蚴性皮炎	zhengzhuang/gyxpy/
构音不良-手笨拙综合征	zhengzhuang/gybl_sbzzhz/
构音不清	zhengzhuang/gybq/
构音障碍	zhengzhuang/gyza/
孤独症	zhengzhuang/gdz/
孤立肾	zhengzhuang/gls/
股部内侧靠近阴囊处的皮疹	zhengzhuang/gbnckjyncdpz/
股动脉枪击音	zhengzhuang/gdmqjy/
股二头肌损伤	zhengzhuang/getjss/
股沟及大腿内侧皮肤有色素沉积	zhengzhuang/ggjdtncpfysscj/
股骨近侧端变宽	zhengzhuang/ggjcdbk/
股前内侧及小腿内侧感觉丧失	zhengzhuang/gqncjxtncgjss/
股前外侧麻木、蚁行感	zhengzhuang/gqwcmm_yxg/
股三角区压痛	zhengzhuang/gsjqyt/
股神经损害	zhengzhuang/gsjsh/
股四头肌损伤	zhengzhuang/gstjss/
骨斑点	zhengzhuang/gbd/
骨痹	zhengzhuang/gb/
骨产道异常	zhengzhuang/gcdyc/
骨刺形成	zhengzhuang/gcxc/
骨脆	zhengzhuang/gc_1368/
骨代谢减低	zhengzhuang/gdxjd/
骨端增大	zhengzhuang/gdzd/
骨缝分开	zhengzhuang/gffk/
骨骼变形缩短	zhengzhuang/ggbxsd/
骨骼表面向外突出	zhengzhuang/ggbmxwtc/
骨骼停止发育	zhengzhuang/ggtzfy/
骨骼肿块	zhengzhuang/ggzk/
骨核出现迟，发育小	zhengzhuang/ghcxc_fyx/
骨骺提前闭合	zhengzhuang/ghtqbh/
骨及软组织肥大	zhengzhuang/gjrzzfd/
骨间肌和鱼际肌萎缩	zhengzhuang/gjjhyjjws/
骨裂	zhengzhuang/gl_1380/
骨龄延迟	zhengzhuang/glyc/
骨密度增加	zhengzhuang/gmdzj/
骨膜反应	zhengzhuang/gmfy/
骨膜炎	zhengzhuang/gmy/
骨内损害	zhengzhuang/gnsh/
骨囊肿	zhengzhuang/gnz/
骨盆损伤	zhengzhuang/gpss/
骨盆痛	zhengzhuang/gpt/
骨皮质变薄	zhengzhuang/gpzbb/
骨气臌	zhengzhuang/gqg/
骨溶解	zhengzhuang/grj/
骨软化	zhengzhuang/grh/
骨软化症骨盆	zhengzhuang/grhzgp/
骨髓的发育异常	zhengzhuang/gsdfyyc/
骨髓浆细胞增多	zhengzhuang/gsjxbzd/
骨髓巨核细胞成熟障碍	zhengzhuang/gsjhxbcsza/
骨髓损害	zhengzhuang/gssh/
骨髓象改变	zhengzhuang/gsxgb/
骨髓象左移现象	zhengzhuang/gsxzyxx/
骨髓抑制	zhengzhuang/gsyz/
骨髓造血细胞再生障碍	zhengzhuang/gszxxbzsza/
骨痛	zhengzhuang/gt/
骨外团块	zhengzhuang/gwtk/
骨无菌性坏死	zhengzhuang/gwjxhs/
骨痒	zhengzhuang/gy_1405/
骨硬化	zhengzhuang/gyh/
骨增粗	zhengzhuang/gzc/
骨质磨损有骨赘增生	zhengzhuang/gzmsygzzs/
骨质破坏	zhengzhuang/gzph/
骨质疏松	zhengzhuang/gzss/
骨转移	zhengzhuang/gzy_1411/
骨赘大量增生	zhengzhuang/gzdlzs/
鼓肠	zhengzhuang/gc_1413/
鼓膜瘢痕化	zhengzhuang/gmbhh/
鼓膜充血	zhengzhuang/gmcx_1415/
鼓膜发红，耳后红肿	zhengzhuang/gmfh_ehhz/
鼓腮和吹口哨漏气	zhengzhuang/gshckslq/
固定于一侧眼及眼眶周围的晚间头痛	zhengzhuang/gdyycyjykzwdwjtt/
怪笑	zhengzhuang/gx/
怪异步态	zhengzhuang/gybt/
关节积液	zhengzhuang/gjjy/
关节畸形	zhengzhuang/gjjx/
关节间隙不规则和关节腔狭窄	zhengzhuang/gjjxbgzhgjqxz/
关节僵直	zhengzhuang/gjjz/
关节局部刺痛	zhengzhuang/gjjbct/
关节挛缩	zhengzhuang/gjls/
关节面不规则硬化	zhengzhuang/gjmbgzyh/
关节囊松弛	zhengzhuang/gjnsc/
关节囊损伤	zhengzhuang/gjnss/
关节扭伤	zhengzhuang/gjns/
关节腔内出血	zhengzhuang/gjqncx/
关节强硬	zhengzhuang/gjqy/
关节强直	zhengzhuang/gjqz/
关节松弛	zhengzhuang/gjsc/
关节酸痛	zhengzhuang/gjst/
关节疼痛	zhengzhuang/gjtt/
关节纤维变性	zhengzhuang/gjxwbx/
关节响痛	zhengzhuang/gjxt/
关节液渗出	zhengzhuang/gjysc/
关节液增加	zhengzhuang/gjyzj/
关节液中白细胞内有尿酸结晶	zhengzhuang/gjyzbxbnynsjj/
关节游走性疼痛，肿胀	zhengzhuang/gjyzxtt_zz/
关节肿大	zhengzhuang/gjzd/
关节肿痛	zhengzhuang/gjzt/
关节肿胀	zhengzhuang/gjzz/
冠状动脉供血不足	zhengzhuang/gzdmgxbz/
冠状动脉痉挛	zhengzhuang/gzdmjl/
冠状动脉窃血现象	zhengzhuang/gzdmqxxx/
冠状动脉栓塞	zhengzhuang/gzdmss/
管型尿	zhengzhuang/gxn/
管型尿	zhengzhuang/gxn_1451/
管性呼吸音	zhengzhuang/gxhxy/
灌肠癖	zhengzhuang/gcp/
光反射消失	zhengzhuang/gfsxs/
光感性皮肤损害	zhengzhuang/ggxpfsh/
光过敏	zhengzhuang/ggm/
胱氨酸储积症	zhengzhuang/gascjz/
广泛红斑浸润损害伴有脱屑	zhengzhuang/gfhbjrshbytx/
广泛性骨质疏松	zhengzhuang/gfxgzss/
广泛性与不定位性腹痛	zhengzhuang/gfxybdwxft/
龟头瘙痒	zhengzhuang/gtsy/
腘动脉搏动减弱或消失	zhengzhuang/gdmbdjrhxs/
过度换气引起晕厥	zhengzhuang/gdhqyqyj/
过度换气综合征	zhengzhuang/gdhqzhz/
过度通气	zhengzhuang/gdtq/
过渡区R波递增不良	zhengzhuang/gdqrbdzbl/
过分地惊跳反应	zhengzhuang/gfdjtfy/
过劳	zhengzhuang/gl_1468/
过敏性皮炎	zhengzhuang/gmxpy/
过强反向性鼻炎	zhengzhuang/gqfxxby/
过早丧失咀嚼功能	zhengzhuang/gzssjjgn/
过早衰老	zhengzhuang/gzsl/
颌骨错位	zhengzhuang/hgcw/
红细胞增多-高粘滞度	zhengzhuang/hxbzd_gzzd/
括约肌功能障碍	zhengzhuang/kyjgnza/
软骨发育不良与骨骼畸形	zhengzhuang/rgfyblyggjx/
“红光满面”	zhengzhuang/_hgmm_/
“蝴蝶状”阴影	zhengzhuang/_hdz_yy/
HBV与HCV重叠感染	zhengzhuang/hbvyhcvzdgr/
HIV感染	zhengzhuang/hivgr/
Howship-Romberg征	zhengzhuang/howship_rombergz/
白色视野缺损	zhengzhuang/bssyqs/
海藻糖酶缺乏	zhengzhuang/hztmqf/
含铁血黄素沉着症	zhengzhuang/htxhsczz/
寒冷刺激下皮损表面出现皱缩	zhengzhuang/hlcjxpsbmcxzs/
寒性体质	zhengzhuang/hxtz/
寒战	zhengzhuang/hz/
汗闭现象	zhengzhuang/hbxx/
汗出如油	zhengzhuang/hcry/
汗毛过多	zhengzhuang/hmgd/
汗腺分泌体味	zhengzhuang/hxfmtw/
毫无情感反应	zhengzhuang/hwqgfy/
喝酒后胃疼	zhengzhuang/hjhwt/
核分裂象增多	zhengzhuang/hflxzd/
核黄疸	zhengzhuang/hhd/
核上性垂直性眼肌瘫痪	zhengzhuang/hsxczxyjth/
核心抗体（抗HBc）阳性	zhengzhuang/hxkt_khbc_yx/
颌骨呈“扇形”骨质破坏	zhengzhuang/hgc_sx_gzph/
颌骨发育过度	zhengzhuang/hgfygd/
颌骨关节痛	zhengzhuang/hggjt/
颌骨内似牙的硬组织	zhengzhuang/hgnsydyzz/
颌骨囊肿	zhengzhuang/hgnz/
颌骨膨隆	zhengzhuang/hgpl/
颌突畸形	zhengzhuang/htjx/
颌下淋巴结肿大压痛	zhengzhuang/hxlbjzdyt/
颌下腺导管口有咸味或脓性分泌物排出	zhengzhuang/hxxdgkyxwhnxfmwpc/
颌下腺疼痛、压痛	zhengzhuang/hxxtt_yt/
颌下腺肿大	zhengzhuang/hxxzd/
颌小	zhengzhuang/hx/
褐色尿	zhengzhuang/hsn/
黑斑	zhengzhuang/hb/
黑便	zhengzhuang/hb_1512/
黑蒙	zhengzhuang/hm/
黑尿	zhengzhuang/hn/
黑色素结石	zhengzhuang/hssjs/
黑头粉刺	zhengzhuang/htfc/
黑痣	zhengzhuang/hz_1517/
横膈低平	zhengzhuang/hgdp/
横结肠息肉	zhengzhuang/hjcxr/
横结肠下垂	zhengzhuang/hjcxc/
横结肠移位	zhengzhuang/hjcyw/
横纹肌溶解	zhengzhuang/hwjrj/
红斑(边界清楚,高出皮肤)	zhengzhuang/hb_bjqc_gcpf_/
红斑结节	zhengzhuang/hbjj/
红斑鳞屑	zhengzhuang/hblx/
红斑性烧伤	zhengzhuang/hbxss/
红斑样皮疹	zhengzhuang/hbypz/
红鼻头	zhengzhuang/hbt/
红赤面	zhengzhuang/hcm/
红色或紫色，稍高起的丘疹或结节	zhengzhuang/hshzs_sgqdqzhjj/
红色盲	zhengzhuang/hsm/
红视	zhengzhuang/hs/
红细胞呈钱串状	zhengzhuang/hxbcqcz/
红细胞分布宽度偏高	zhengzhuang/hxbfbkdpg/
红细胞畸形	zhengzhuang/hxbjx/
红细胞偏低	zhengzhuang/hxbpd/
红细胞寿命缩短	zhengzhuang/hxbsmsd/
红细胞体积增大	zhengzhuang/hxbtjzd/
红细胞压积偏高	zhengzhuang/hxbyjpg/
红细胞增多	zhengzhuang/hxbzd/
红眼	zhengzhuang/hy/
红晕	zhengzhuang/hy_1542/
洪脉	zhengzhuang/hm_1543/
虹膜表面形成灰白色肿瘤结节	zhengzhuang/hmbmxchbszljj/
虹膜发炎	zhengzhuang/hmfy/
虹膜根部离断	zhengzhuang/hmgbld/
虹膜节段性萎缩	zhengzhuang/hmjdxws/
虹膜蓝色	zhengzhuang/hmls/
虹膜缺损	zhengzhuang/hmqs/
虹膜新生血管与纤维血管膜	zhengzhuang/hmxsxgyxwxgm/
虹膜异色	zhengzhuang/hmys/
虹视	zhengzhuang/hs_1552/
喉部刺痛	zhengzhuang/hbct/
喉部堵塞感	zhengzhuang/hbdsg/
喉部痉挛	zhengzhuang/hbjl/
喉部淋巴滤泡增生	zhengzhuang/hblblpzs/
喉部有痰	zhengzhuang/hbyt/
喉管阻塞	zhengzhuang/hgzs/
喉肌无力	zhengzhuang/hjwl/
喉结不明显	zhengzhuang/hjbmx/
喉结增大	zhengzhuang/hjzd/
喉咙冒黏液	zhengzhuang/hlmny/
喉咙痛	zhengzhuang/hlt/
喉咙痒	zhengzhuang/hly/
喉弥漫性黏膜肥厚，凹凸不平	zhengzhuang/hmmxnmfh_atbp/
喉鸣声	zhengzhuang/hms/
喉头发紧	zhengzhuang/htfj/
喉头痉挛	zhengzhuang/htjl/
喉头水肿	zhengzhuang/htsz/
喉头增大	zhengzhuang/htzd/
喉痒咳嗽	zhengzhuang/hyks/
后发际低	zhengzhuang/hfjd/
后发性遗忘	zhengzhuang/hfxyw/
后腹膜纤维化	zhengzhuang/hfmxwh/
后脑勺疼	zhengzhuang/hnst/
呼气困难	zhengzhuang/hqkn/
呼气时两颊鼓起和缩唇	zhengzhuang/hqsljgqhsc/
呼气时胸口痛	zhengzhuang/hqsxkt/
呼气音延长	zhengzhuang/hqyyc/
呼气中有甜臭味	zhengzhuang/hqzytcw/
呼吸不规则	zhengzhuang/hxbgz/
呼吸道狭窄	zhengzhuang/hxdxz/
呼吸道阻塞	zhengzhuang/hxdzs/
呼吸反射调节受损	zhengzhuang/hxfsdjss/
呼吸功能衰竭	zhengzhuang/hxgnsj/
呼吸急促	zhengzhuang/hxjc/
呼吸减慢而不规则	zhengzhuang/hxjmebgz/
呼吸窘迫综合症	zhengzhuang/hxjpzhz/
呼吸困难	zhengzhuang/hxkn/
呼吸气为腐臭味	zhengzhuang/hxqwfcw/
呼吸气为酒味	zhengzhuang/hxqwjw/
呼吸气为尿臭味	zhengzhuang/hxqwncw/
呼吸气为蒜臭味	zhengzhuang/hxqwscw/
呼吸浅慢	zhengzhuang/hxqm/
呼吸衰竭	zhengzhuang/hxsj/
呼吸速率减慢且规则	zhengzhuang/hxsljmqgz/
呼吸性碱中毒	zhengzhuang/hxxjzd/
呼吸性酸中毒	zhengzhuang/hxxszd/
呼吸异常	zhengzhuang/hxyc/
呼吸抑制	zhengzhuang/hxyz/
呼吸音粗糙	zhengzhuang/hxycc/
呼吸音低	zhengzhuang/hxyd/
呼吸音减弱	zhengzhuang/hxyjr/
呼吸暂停样现象	zhengzhuang/hxztyxx/
呼吸中可有烂苹果味	zhengzhuang/hxzkylpgw/
胡萝卜素血症	zhengzhuang/hlbsxz/
胡子发黄	zhengzhuang/hzfh/
胡子稀疏	zhengzhuang/hzxs/
虎眼征	zhengzhuang/hyz/
滑脉	zhengzhuang/hm_1610/
滑膜发炎	zhengzhuang/hmfy_1611/
滑膜黑染	zhengzhuang/hmhr/
滑膜增厚	zhengzhuang/hmzh/
化脓结痂	zhengzhuang/hnjj/
化脓性腮腺炎	zhengzhuang/hnxsxy/
化学性皮肤灼伤	zhengzhuang/hxxpfzs/
化学性支气管炎	zhengzhuang/hxxzqgy/
化妆品的毛发损害	zhengzhuang/hzpdmfsh/
怀孕时子宫异常增大	zhengzhuang/hyszgyczd/
踝部凹陷性水肿	zhengzhuang/hbaxxsz/
踝部及足背水肿	zhengzhuang/hbjzbsz/
踝关节屈曲挛缩畸形	zhengzhuang/hgjqqlsjx/
踝关节疼痛	zhengzhuang/hgjtt/
踝关节肿胀	zhengzhuang/hgjzz/
踝及足麻木和有灼痛感	zhengzhuang/hjzmmhyztg/
踝膝关节积液	zhengzhuang/hxgjjy/
踝阵挛	zhengzhuang/hzl/
坏疽脓皮	zhengzhuang/hjnp/
坏死性筋膜炎	zhengzhuang/hsxjmy/
环甲肌失去收缩或牵引感	zhengzhuang/hjjsqsshqyg/
环咽部运动障碍	zhengzhuang/hybydza/
环状肉芽肿	zhengzhuang/hzryz/
寰枢关节不稳定	zhengzhuang/hsgjbwd/
寰枢脱位	zhengzhuang/hstw/
缓脉	zhengzhuang/hm_1635/
幻觉	zhengzhuang/hj/
幻听	zhengzhuang/ht/
幻味	zhengzhuang/hw/
幻想失去时间和空间感觉	zhengzhuang/hxsqsjhkjgj/
幻肢痛	zhengzhuang/hzt/
慌张步态	zhengzhuang/hzbt/
黄白色黏痰有水果味	zhengzhuang/hbsntysgw/
黄斑回避现象	zhengzhuang/hbhbxx/
黄斑囊样水肿	zhengzhuang/hbnysz/
黄斑盘状变性	zhengzhuang/hbpzbx/
黄疸	zhengzhuang/hd/
黄韧带肥厚	zhengzhuang/hrdfh/
黄色蛋花样稀便	zhengzhuang/hsdhyxb/
黄色发亮结痂	zhengzhuang/hsfljj/
黄色结节	zhengzhuang/hsjj/
黄视	zhengzhuang/hs_1651/
黄素化囊肿	zhengzhuang/hshnz/
黄体破裂	zhengzhuang/htpl/
黄指甲	zhengzhuang/hzj/
灰白大便	zhengzhuang/hbdb/
灰白色结节	zhengzhuang/hbsjj/
回肠重复畸形	zhengzhuang/hczfjx/
回盲瓣功能不全	zhengzhuang/hmbgnbq/
回盲部结核	zhengzhuang/hmbjh/
回声阴影	zhengzhuang/hsyy/
回吸性涕血	zhengzhuang/hxxtx/
蛔虫感染	zhengzhuang/hcgr/
蛔虫性肠梗阻	zhengzhuang/hcxcgz/
会厌炎	zhengzhuang/hyy/
会阴部牵引痛	zhengzhuang/hybqyt/
会阴部撕裂感	zhengzhuang/hybslg/
会阴溃疡	zhengzhuang/hyky/
会阴瘘管或窦道形成	zhengzhuang/hylghddxc/
会阴痒	zhengzhuang/hyy_1669/
昏迷	zhengzhuang/hm_1670/
昏睡	zhengzhuang/hs_1671/
浑身忽冷忽热	zhengzhuang/hshlhr/
浑身酸痛	zhengzhuang/hsst/
混合型酸碱平衡紊乱	zhengzhuang/hhxsjphwl/
混浊尿	zhengzhuang/hzn/
活动后气促	zhengzhuang/hdhqc/
获得性肥胖	zhengzhuang/hdxfp/
霍纳综合征	zhengzhuang/hnzhz/
喜讲秽语	zhengzhuang/xjhy/
“鸡盲”或“雀盲”	zhengzhuang/_jm_h_qm_/
蹲踞现象	zhengzhuang/djxx/
发作间精神障碍	zhengzhuang/fzjjsza/
肛门区红肿及痛性硬块	zhengzhuang/gmqhzjtxyk/
肛门瘙痒	zhengzhuang/gmsy/
饥饿时上腹痛	zhengzhuang/jessft/
机械地重复周围人的言语或行为	zhengzhuang/jxdzfzwrdyyhxw/
机械性压迫	zhengzhuang/jxxyp/
肌腱端炎	zhengzhuang/jjdy/
肌腱断裂	zhengzhuang/jjdl/
肌腱拉伤	zhengzhuang/jjls/
肌腱囊肿	zhengzhuang/jjnz/
肌腱扭伤	zhengzhuang/jjns/
肌腱粘连	zhengzhuang/jjzl/
肌肉出血	zhengzhuang/jrcx/
肌肉挫伤	zhengzhuang/jrcs/
肌肉的失用性萎缩	zhengzhuang/jrdsyxws/
肌肉发育不良	zhengzhuang/jrfybl/
肌肉肥大	zhengzhuang/jrfd/
肌肉坏死	zhengzhuang/jrhs/
肌肉假肥大	zhengzhuang/jrjfd/
肌肉紧张性疼痛	zhengzhuang/jrjzxtt/
肌肉痉挛性疼痛	zhengzhuang/jrjlxtt/
肌肉拉伤	zhengzhuang/jrls/
肌肉挛缩	zhengzhuang/jrls_1705/
肌肉撕裂	zhengzhuang/jrsl/
肌肉酸痛	zhengzhuang/jrst/
肌肉跳动	zhengzhuang/jrtd/
肌肉完全断裂	zhengzhuang/jrwqdl/
肌肉萎缩	zhengzhuang/jrws/
肌肉纤维震颤	zhengzhuang/jrxwzc/
肌肉压痛	zhengzhuang/jryt/
肌肉硬结	zhengzhuang/jryj/
肌肉砸伤	zhengzhuang/jrzs/
肌肉撞伤	zhengzhuang/jrzs_1715/
肌束震颤	zhengzhuang/jszc/
肌体张力异常	zhengzhuang/jtzlyc/
肌痛	zhengzhuang/jt/
肌无力危象	zhengzhuang/jwlwx/
肌纤维颤搐	zhengzhuang/jxwcc/
肌纤维大小不等	zhengzhuang/jxwdxbd/
肌性肌无力	zhengzhuang/jxjwl/
肌张力过高	zhengzhuang/jzlgg/
肌张力减低	zhengzhuang/jzljd/
肌张力降低	zhengzhuang/jzljd_1725/
肌阵挛	zhengzhuang/jzl/
鸡眼	zhengzhuang/jy/
基底节出血	zhengzhuang/jdjcx/
基因融合	zhengzhuang/jyrh/
稽留流产	zhengzhuang/jllc/
稽留热	zhengzhuang/jlr/
极速型心率	zhengzhuang/jsxxl/
极重度精神发育迟滞	zhengzhuang/jzdjsfycz/
急腹症	zhengzhuang/jfz/
急性病容	zhengzhuang/jxbr/
急性肠扭转	zhengzhuang/jxcnz/
急性房颤	zhengzhuang/jxfc/
急性非化脓性一过性颈淋巴结肿胀	zhengzhuang/jxfhnxygxjlbjzz/
急性腹痛	zhengzhuang/jxft/
急性宫颈炎	zhengzhuang/jxgjy/
急性呼吸窘迫综合征	zhengzhuang/jxhxjpzhz/
急性呼吸困难	zhengzhuang/jxhxkn/
急性面容	zhengzhuang/jxmr/
急性尿潴留	zhengzhuang/jxnzl/
急性贫血	zhengzhuang/jxpx/
急性溶血性尿毒综合征	zhengzhuang/jxrxxndzhz/
急性肾衰竭	zhengzhuang/jxssj/
急性胃扩张	zhengzhuang/jxwkz/
急性胃痛	zhengzhuang/jxwt/
急性下肢缺血	zhengzhuang/jxxzqx/
急性阴道感染	zhengzhuang/jxydgr/
棘突压痛	zhengzhuang/jtyt/
集合管或乳头弥散性真菌浸润	zhengzhuang/jhghrtmsxzjjr/
挤压伤	zhengzhuang/jys/
脊肋角膨隆	zhengzhuang/jljpl/
脊神经根受损	zhengzhuang/jsjgss/
脊神经压迫	zhengzhuang/jsjyp/
脊髓半切综合征	zhengzhuang/jsbqzhz/
脊髓病变	zhengzhuang/jsbb/
脊髓出血	zhengzhuang/jscx/
脊髓的浸润	zhengzhuang/jsdjr/
脊髓梗死	zhengzhuang/jsgs/
脊髓横贯损害	zhengzhuang/jshgsh/
脊髓马尾受累	zhengzhuang/jsmwsl/
脊髓内胶质增生	zhengzhuang/jsnjzzs/
脊髓内空洞形成	zhengzhuang/jsnkdxc/
脊髓前角病变	zhengzhuang/jsqjbb/
脊髓丘脑束受压	zhengzhuang/jsqnssy/
脊髓缺血	zhengzhuang/jsqx/
脊髓受压	zhengzhuang/jssy/
脊髓性肌萎缩	zhengzhuang/jsxjws/
脊髓性间歇破行	zhengzhuang/jsxjxpx/
脊髓休克	zhengzhuang/jsxk/
脊髓压迫	zhengzhuang/jsyp/
脊突叩痛	zhengzhuang/jtkt/
脊柱病变性骨盆畸形	zhengzhuang/jzbbxgpjx/
脊柱侧弯	zhengzhuang/jzcw/
脊柱的成角畸形	zhengzhuang/jzdcjjx/
脊柱骨质改变	zhengzhuang/jzgzgb/
脊柱和四肢畸形	zhengzhuang/jzhszjx/
脊柱后突	zhengzhuang/jzht/
脊柱裂	zhengzhuang/jzl_1782/
脊柱破坏	zhengzhuang/jzph/
脊柱前突变直局部叩痛	zhengzhuang/jzqtbzjbkt/
脊柱生理弯曲消失	zhengzhuang/jzslwqxs/
脊柱退变	zhengzhuang/jztb/
脊柱弯曲	zhengzhuang/jzwq/
脊椎僵直	zhengzhuang/jzjz/
记忆力消失	zhengzhuang/jylxs/
记忆力障碍	zhengzhuang/jylza/
记忆受损	zhengzhuang/jyss/
技术狂躁症	zhengzhuang/jskzz/
季节性浅红斑片	zhengzhuang/jjxqhbp/
季节性情绪抑郁	zhengzhuang/jjxqxyy/
季节性手脱皮	zhengzhuang/jjxstp/
继发感染	zhengzhuang/jfgr/
继发性闭经	zhengzhuang/jfxbj/
继发性便秘	zhengzhuang/jfxbm/
继发性不孕	zhengzhuang/jfxby/
继发性癫痫	zhengzhuang/jfxdx/
继发性肥胖	zhengzhuang/jfxfp/
继发性高血压	zhengzhuang/jfxgxy/
继发性失眠	zhengzhuang/jfxsm/
继发性视神经萎缩	zhengzhuang/jfxssjws/
继发性痛经	zhengzhuang/jfxtj/
继发性纤溶功能增强	zhengzhuang/jfxxrgnzq/
寂静腹	zhengzhuang/jjf/
夹层血肿	zhengzhuang/jcxz/
颊部脂肪消失呈老年人面容	zhengzhuang/jbzfxsclnrmr/
甲亢面容	zhengzhuang/jkmr/
甲亢危象	zhengzhuang/jkwx/
甲身凹沟	zhengzhuang/jsag/
甲胎蛋白增高	zhengzhuang/jtdbzg/
甲下出血	zhengzhuang/jxcx/
甲营养不良	zhengzhuang/jyybl/
甲周炎	zhengzhuang/jzy/
甲皱毛细血管袢数减少	zhengzhuang/jzmxxgpsjs/
甲状旁腺功能亢进	zhengzhuang/jzpxgnkj/
甲状旁腺机能减退	zhengzhuang/jzpxjnjt/
甲状软骨下可触及异物撞击震动感	zhengzhuang/jzrgxkcjywzjzdg/
甲状腺功能低下	zhengzhuang/jzxgndx/
甲状腺机能亢进	zhengzhuang/jzxjnkj/
甲状腺扪及光滑坚实的椭圆形结节	zhengzhuang/jzxmjghjsdtyxjj/
甲状腺肿	zhengzhuang/jzxz/
甲状腺肿大	zhengzhuang/jzxzd/
假结核结节	zhengzhuang/jjhjj/
假菊形团结构	zhengzhuang/jjxtjg/
假临产	zhengzhuang/jlc/
假期综合症	zhengzhuang/jqzhz/
假日心脏综合征	zhengzhuang/jrxzzhz/
假声现象	zhengzhuang/jsxx/
假笑	zhengzhuang/jx/
假性宫缩	zhengzhuang/jxgs/
假性前房积脓	zhengzhuang/jxqfjn/
假性延髓性麻痹	zhengzhuang/jxysxmb/
假性幽门化生	zhengzhuang/jxymhs/
假牙疼痛	zhengzhuang/jytt/
假孕	zhengzhuang/jy_1838/
尖头并指	zhengzhuang/jtbz/
间歇热	zhengzhuang/jxr/
间歇性鼻阻塞	zhengzhuang/jxxbzs/
间歇性跛行	zhengzhuang/jxxbx/
间歇性耳痛	zhengzhuang/jxxet/
间歇性寒颤	zhengzhuang/jxxhc/
间歇性尿蛋白	zhengzhuang/jxxndb/
间歇性失忆	zhengzhuang/jxxsy/
间歇性头痛	zhengzhuang/jxxtt/
间歇性头晕	zhengzhuang/jxxty/
间歇性胃痛	zhengzhuang/jxxwt/
间歇性血尿	zhengzhuang/jxxxn/
肩膀酸疼	zhengzhuang/jbst/
肩背部沉重感	zhengzhuang/jbbczg/
肩背部肌肉痛	zhengzhuang/jbbjrt/
肩背痛	zhengzhuang/jbt/
肩臂外侧的感觉障碍和功能受限	zhengzhuang/jbwcdgjzahgnsx/
肩部或肩胛区持续钝痛和深部钻刺样不适感	zhengzhuang/jbhjjqcxdthsbzcybsg/
肩部牵涉痛	zhengzhuang/jbqst/
肩部运动受限	zhengzhuang/jbydsx/
肩带肌、上肢和胸背部诸肌的肌无力和肌萎缩	zhengzhuang/jdj_szhxbbzjdjwlhjws/
肩关节活动受限	zhengzhuang/jgjhdsx/
肩关节痛	zhengzhuang/jgjt/
肩胛带“模拟瘫痪”	zhengzhuang/jjd_mnth_/
肩胛带的肌肉不发达	zhengzhuang/jjddjrbfd/
肩胛带和上肢疼痛	zhengzhuang/jjdhsztt/
肩胛带肌肉萎缩	zhengzhuang/jjdjrws/
肩胛放射性疼痛	zhengzhuang/jjfsxtt/
肩胛骨酸痛	zhengzhuang/jjgst/
肩胛骨突出	zhengzhuang/jjgtc/
肩节后脱位	zhengzhuang/jjhtw/
肩痛	zhengzhuang/jt_1870/
肩周区弥散的钝痛及放射痛	zhengzhuang/jzqmsddtjfst/
肩周酸痛不适	zhengzhuang/jzstbs/
缄默症	zhengzhuang/jmz/
睑结膜的巨大乳头	zhengzhuang/jjmdjdrt/
睑结膜硬而扁平的乳头	zhengzhuang/jjmyebpdrt/
睑内翻	zhengzhuang/jnf/
睑外翻	zhengzhuang/jwf/
睑缘呈横“S”形下垂	zhengzhuang/jych_s_xxc/
碱烧伤	zhengzhuang/jss/
碱性磷酸酶增高	zhengzhuang/jxlsmzg/
健康线异常	zhengzhuang/jkxyc/
健忘	zhengzhuang/jw/
健忘性失语	zhengzhuang/jwxsy/
腱反射亢进	zhengzhuang/jfskj/
腱反射消失	zhengzhuang/jfsxs/
腱反射异常	zhengzhuang/jfsyc/
腱或腱止点处增粗或钙化	zhengzhuang/jhjzdczchgh/
腱鞘变干	zhengzhuang/jqbg/
腱索断裂	zhengzhuang/jsdl/
浆液脓性分泌物	zhengzhuang/jynxfmw/
讲话频率小，不能发高音	zhengzhuang/jhplx_bnfgy/
交叉腿	zhengzhuang/jct/
交叉注视	zhengzhuang/jczs/
交感神经代偿性亢进	zhengzhuang/jgsjdcxkj/
交感神经高度紧张	zhengzhuang/jgsjgdjz/
交替脉	zhengzhuang/jtm/
交替使用双眼	zhengzhuang/jtsysy/
交替性暴食厌食	zhengzhuang/jtxbsys/
胶冻状便	zhengzhuang/jdzb/
焦痂性烧伤	zhengzhuang/jjxss/
焦虑	zhengzhuang/jl/
焦虑性适应障碍	zhengzhuang/jlxsyza/
焦虑致胸口痛	zhengzhuang/jlzxkt/
角弓反张	zhengzhuang/jgfz/
角弓反张位	zhengzhuang/jgfzw/
巩膜葡萄肿	zhengzhuang/gmptz/
角回受损	zhengzhuang/jhss/
角结膜干燥症	zhengzhuang/jjmgzz/
角膜表面三角形胬肉	zhengzhuang/jmbmsjxnr/
角膜大小不等的透明水泡	zhengzhuang/jmdxbddtmsp/
角膜反射迟钝	zhengzhuang/jmfscd/
角膜干燥斑	zhengzhuang/jmgzb/
角膜后胚胎环	zhengzhuang/jmhpth/
角膜混浊	zhengzhuang/jmhz/
角膜晶状体粘连	zhengzhuang/jmjztzl/
角膜溃疡	zhengzhuang/jmky/
角膜瘘	zhengzhuang/jml/
角膜糜烂	zhengzhuang/jmml/
角膜色膜环	zhengzhuang/jmsmh/
角膜上点状暗灰色混浊	zhengzhuang/jmsdzahshz/
角膜上皮糜烂	zhengzhuang/jmspml/
角膜烧伤	zhengzhuang/jmss/
角膜树枝状改变	zhengzhuang/jmszzgb/
角膜外缘有棕绿色色素环	zhengzhuang/jmwyyzlsssh/
角膜炎	zhengzhuang/jmy/
角膜异物	zhengzhuang/jmyw/
角膜有菌苔或溃疡	zhengzhuang/jmyjthky/
角膜知觉减少	zhengzhuang/jmzjjs/
角膜中央后部典型碎银状外貌	zhengzhuang/jmzyhbdxsyzwm/
角膜灼伤刮伤	zhengzhuang/jmzsgs/
角栓	zhengzhuang/js/
角形甲弧影	zhengzhuang/jxjhy/
角质层过度增厚	zhengzhuang/jzcgdzh/
角质化	zhengzhuang/jzh/
角质增厚	zhengzhuang/jzzh/
脚臭	zhengzhuang/jc/
脚底干裂	zhengzhuang/jdgl/
脚冻伤	zhengzhuang/jds/
脚后跟长骨刺	zhengzhuang/jhgcgc/
脚气	zhengzhuang/jq/
脚上血泡	zhengzhuang/jsxp/
脚外侧疼	zhengzhuang/jwct/
脚趾甲内长	zhengzhuang/jzjnc/
脚趾皮肤黄泡后紫黑	zhengzhuang/jzpfhphzh/
疖肿	zhengzhuang/jz/
节段性分离性感觉障碍	zhengzhuang/jdxflxgjza/
节段性肌张力障碍	zhengzhuang/jdxjzlza/
节律性刻板重复的不自主运动	zhengzhuang/jlxkbzfdbzzyd/
结肠袋半月襞消失	zhengzhuang/jcdbybxs/
结肠粪性穿孔	zhengzhuang/jcfxck/
结肠梗阻	zhengzhuang/jcgz/
结肠黑变	zhengzhuang/jchb/
结肠内形成坚硬的粪石	zhengzhuang/jcnxcjydfs/
结肠膨胀	zhengzhuang/jcpz/
结肠憩室	zhengzhuang/jcqs/
结肠息肉	zhengzhuang/jcxr/
结肠血管发育不良	zhengzhuang/jcxgfybl/
结缔组织性外痔	zhengzhuang/jdzzxwz/
结核杆菌血行播散	zhengzhuang/jhgjxxbs/
结核中毒	zhengzhuang/jhzd/
结痂	zhengzhuang/jj/
结节	zhengzhuang/jj_1962/
结节性硬化	zhengzhuang/jjxyh/
结脉	zhengzhuang/jm/
结膜变浅或变苍白	zhengzhuang/jmbqhbcb/
结膜充血	zhengzhuang/jmcx/
结膜干燥斑	zhengzhuang/jmgzb_1967/
结膜乳头增生	zhengzhuang/jmrtzs/
结膜异物	zhengzhuang/jmyw_1969/
睫毛掉落	zhengzhuang/jmdl/
睫状充血	zhengzhuang/jzcx/
截瘫	zhengzhuang/jt_1972/
戒断反应	zhengzhuang/jdfy/
戒断性痫性发作	zhengzhuang/jdxxxfz/
疥疮	zhengzhuang/jc_1975/
疥疮结节	zhengzhuang/jcjj/
疥疮恐惧	zhengzhuang/jckj/
金鱼眼	zhengzhuang/jyy/
金属音调咳嗽	zhengzhuang/jsydks/
津亏血燥	zhengzhuang/jkxz/
筋膜疼痛	zhengzhuang/jmtt/
紧箍咒一样头紧	zhengzhuang/jgzyytj/
紧脉	zhengzhuang/jm_1983/
紧张	zhengzhuang/jz_1984/
紧张性木僵	zhengzhuang/jzxmj/
紧张性疲劳	zhengzhuang/jzxpl/
紧张性失眠	zhengzhuang/jzxsm/
紧张性手抖	zhengzhuang/jzxsd/
紧张性头痛	zhengzhuang/jzxtt/
紧张性头晕	zhengzhuang/jzxty/
近迫性昏迷	zhengzhuang/jpxhm/
近迫性心肌梗塞	zhengzhuang/jpxxjgs/
近曲小管受累	zhengzhuang/jqxgsl/
近事遗忘现象	zhengzhuang/jsywxx/
近视弧	zhengzhuang/jsh/
近视散光	zhengzhuang/jssg/
进食过硬的食物口腔损伤	zhengzhuang/jsgydswkqss/
进食后出现弥漫性腹部绞痛	zhengzhuang/jshcxmmxfbjt/
进食困难	zhengzhuang/jskn/
进食流泪	zhengzhuang/jsll/
进食呕吐	zhengzhuang/jsot/
进食样自动症	zhengzhuang/jsyzdz/
进食异常	zhengzhuang/jsyc/
进行性痴呆	zhengzhuang/jxxcd/
进行性肝缩小	zhengzhuang/jxxgsx/
进行性肌麻痹	zhengzhuang/jxxjmb/
进行性颈部肿块	zhengzhuang/jxxjbzk/
进行性肉芽性溃疡坏死	zhengzhuang/jxxryxkyhs/
进行性消瘦	zhengzhuang/jxxxs/
经常说梦话	zhengzhuang/jcsmh/
经络阻塞	zhengzhuang/jlzs/
经期便血	zhengzhuang/jqbx/
经期出血	zhengzhuang/jqcx/
经期浮肿	zhengzhuang/jqfz/
经期前后小腹坠痛	zhengzhuang/jqqhxfzt/
经期前乳房痛	zhengzhuang/jqqrft/
经期缩短	zhengzhuang/jqsd/
经期提前	zhengzhuang/jqtq/
经期头痛	zhengzhuang/jqtt/
经期推迟	zhengzhuang/jqtc/
经期小腹坠痛	zhengzhuang/jqxfzt/
经期肿胀	zhengzhuang/jqzz/
经前期膝痛	zhengzhuang/jqqxt/
经前综合症	zhengzhuang/jqzhz_2024/
惊厥	zhengzhuang/jj_2025/
惊恐发作	zhengzhuang/jkfz/
惊跳	zhengzhuang/jt_2027/
晶状体蛋白逸出	zhengzhuang/jztdbyc/
晶状体混浊	zhengzhuang/jzthz/
晶状体囊壁破裂	zhengzhuang/jztnbpl/
晶状体膨胀增大	zhengzhuang/jztpzzd/
晶状体青光眼斑	zhengzhuang/jztqgyb/
晶状体铁质沉着	zhengzhuang/jzttzcz/
晶状体突出	zhengzhuang/jzttc/
晶状体脱位或半脱位	zhengzhuang/jzttwhbtw/
晶状体移位	zhengzhuang/jztyw/
晶状体皱缩	zhengzhuang/jztzs/
精囊缩小	zhengzhuang/jnsx/
精囊增大	zhengzhuang/jnzd/
精神变态	zhengzhuang/jsbt/
精神创伤	zhengzhuang/jscs/
精神过敏	zhengzhuang/jsgm/
精神活性物质所致精神障碍	zhengzhuang/jshxwzszjsza/
精神萎靡	zhengzhuang/jswm/
精神依赖性	zhengzhuang/jsylx/
精神运动性活动变坏	zhengzhuang/jsydxhdbh/
精神运动性兴奋	zhengzhuang/jsydxxf/
精神障碍	zhengzhuang/jsza/
精索静脉曲张	zhengzhuang/jsjmqz/
精索增粗肿胀	zhengzhuang/jszczz/
精虚血弱	zhengzhuang/jxxr/
精血不足	zhengzhuang/jxbz/
精液稠	zhengzhuang/jyc/
精液带血	zhengzhuang/jydx/
精液发黄	zhengzhuang/jyfh/
精液量多	zhengzhuang/jyld/
精液少	zhengzhuang/jys_2057/
精液稀	zhengzhuang/jyx/
精子不液化	zhengzhuang/jzbyh/
精子存活率低	zhengzhuang/jzchld/
精子大头畸形	zhengzhuang/jzdtjx/
精子活力低	zhengzhuang/jzhld/
精子活力低	zhengzhuang/jzhld_2063/
精子凝集	zhengzhuang/jznj/
精子稀少	zhengzhuang/jzxs/
精子异常	zhengzhuang/jzyc/
精子质量下降	zhengzhuang/jzzlxj/
颈背部肌肉痉挛	zhengzhuang/jbbjrjl/
颈背疼痛	zhengzhuang/jbtt/
颈部搏动	zhengzhuang/jbbd/
颈部不稳感	zhengzhuang/jbbwg/
颈部潮红	zhengzhuang/jbch/
颈部呈僵直状	zhengzhuang/jbcjzz/
颈部粗	zhengzhuang/jbc/
颈部肌肉肿胀变硬	zhengzhuang/jbjrzzby/
颈部僵硬	zhengzhuang/jbjy/
颈部可前屈，怕仰伸	zhengzhuang/jbkqq_pys/
颈部淋巴结肿大	zhengzhuang/jblbjzd/
颈部囊性病变	zhengzhuang/jbnxbb/
颈部扭伤	zhengzhuang/jbns/
颈部怕前屈，怕仰伸	zhengzhuang/jbpqq_pys/
颈部强硬	zhengzhuang/jbqy/
颈部缺血性跳痛	zhengzhuang/jbqxxtt/
颈部烧伤	zhengzhuang/jbss/
颈部酸痛	zhengzhuang/jbst_2085/
颈部疼痛	zhengzhuang/jbtt_2086/
颈部有擦伤痕迹或肿胀	zhengzhuang/jbycshjhzz/
颈部皱纹多	zhengzhuang/jbzwd/
颈动脉搏动减弱或消失	zhengzhuang/jdmbdjrhxs/
颈动脉窦性晕厥	zhengzhuang/jdmdxyj/
颈动脉痛	zhengzhuang/jdmt/
颈短	zhengzhuang/jd/
颈根部斜方肌及风池穴处有压痛点	zhengzhuang/jgbxfjjfcxcyytd/
颈后及肩部皮肤发硬	zhengzhuang/jhjjbpffy/
颈肩疲劳和软组织疼痛	zhengzhuang/jjplhrzztt/
颈肩痛	zhengzhuang/jjt/
颈交感链受累	zhengzhuang/jjglsl/
颈静脉充盈	zhengzhuang/jjmcy/
颈静脉怒张	zhengzhuang/jjmnz/
颈内动脉创伤性血栓	zhengzhuang/jndmcsxxs/
颈强直	zhengzhuang/jqz/
颈软不能抬头	zhengzhuang/jrbntt/
颈髓脱髓鞘性病变	zhengzhuang/jstsqxbb/
颈髓完全性损伤	zhengzhuang/jswqxss/
颈髓硬膜外病变	zhengzhuang/jsymwbb/
颈性高血压	zhengzhuang/jxgxy/
颈性头痛	zhengzhuang/jxtt/
颈性眩晕	zhengzhuang/jxxy/
颈椎变形	zhengzhuang/jzbx/
颈椎肥大	zhengzhuang/jzfd/
颈椎分节异常	zhengzhuang/jzfjyc/
颈椎骨折脱位	zhengzhuang/jzgztw/
颈椎关节的根性疼痛	zhengzhuang/jzgjdgxtt/
颈椎间盘突出	zhengzhuang/jzjptc/
颈椎间盘退变	zhengzhuang/jzjptb/
颈椎痛	zhengzhuang/jzt/
颈椎退化	zhengzhuang/jzth/
颈椎增生	zhengzhuang/jzzs/
颈椎椎节已有明显退行性变	zhengzhuang/jzzjyymxtxxb/
胫骨粗隆肿胀	zhengzhuang/jgclzz/
胫骨干骨不连	zhengzhuang/jgggbl/
胫骨假关节形成	zhengzhuang/jgjgjxc/
胫骨结节处的酸痛，肿胀	zhengzhuang/jgjjcdst_zz/
胫骨疼痛	zhengzhuang/jgtt/
胫骨压痛	zhengzhuang/jgyt/
胫前和足部坚硬的非凹陷性水肿斑块	zhengzhuang/jqhzbjydfaxxszbk/
胫前黑斑	zhengzhuang/jqhb/
胫前指压性水肿	zhengzhuang/jqzyxsz/
痉挛性便秘	zhengzhuang/jlxbm/
痉挛性的肌张力增高	zhengzhuang/jlxdjzlzg/
痉挛性截瘫步态	zhengzhuang/jlxjtbt/
痉挛性截瘫期	zhengzhuang/jlxjtq/
痉挛性咳嗽	zhengzhuang/jlxks/
痉挛性偏瘫步态	zhengzhuang/jlxptbt/
痉挛性斜颈	zhengzhuang/jlxxj/
痉笑面容	zhengzhuang/jxmr_2136/
静脉侧支循环建立	zhengzhuang/jmczxhjl/
静脉出血	zhengzhuang/jmcx_2138/
静脉逗	zhengzhuang/jmd/
静脉回流障碍	zhengzhuang/jmhlza/
静脉内持续性血流	zhengzhuang/jmncxxxl/
静脉曲张	zhengzhuang/jmqz/
静脉曲张性溃疡	zhengzhuang/jmqzxky/
静脉曲张性外痔	zhengzhuang/jmqzxwz/
静脉栓塞	zhengzhuang/jmss_2145/
静脉萎陷	zhengzhuang/jmwx/
静脉血流滞缓	zhengzhuang/jmxlzh/
静脉血栓	zhengzhuang/jmxs/
静脉血氧饱和度（SVO2）降低	zhengzhuang/jmxybhd_svo2_jd/
静止性结石	zhengzhuang/jzxjs/
静止性震颤	zhengzhuang/jzxzc/
镜面舌	zhengzhuang/jms/
镜子征	zhengzhuang/jzz/
久病亏损	zhengzhuang/jbks/
久不消退的红色皮肤疤	zhengzhuang/jbxtdhspfb/
酒悖	zhengzhuang/jb/
酒后便血	zhengzhuang/jhbx/
酒后四肢酸痛	zhengzhuang/jhszst/
酒精成瘾	zhengzhuang/jjcy/
酒精过敏	zhengzhuang/jjgm/
酒精性肝硬化	zhengzhuang/jjxgyh/
酒精性幻觉症	zhengzhuang/jjxhjz/
酒精性胃黏膜损伤	zhengzhuang/jjxwnmss/
酒精性心肌	zhengzhuang/jjxxj/
酒精性震颤	zhengzhuang/jjxzc/
酒精依赖	zhengzhuang/jjyl/
酒精中毒性幻觉症	zhengzhuang/jjzdxhjz/
酒精中毒性嫉妒妄想	zhengzhuang/jjzdxjdwx/
酒精中毒性偏执状态	zhengzhuang/jjzdxpzzt/
酒糟鼻	zhengzhuang/jzb/
局部静脉压痛	zhengzhuang/jbjmyt/
局部静脉硬索状	zhengzhuang/jbjmysz/
局部可摸到肌腹与肌腱连接处略有缺失与下陷	zhengzhuang/jbkmdjfyjjljclyqsyxx/
局部淋巴结肿大	zhengzhuang/jblbjzd_2174/
局部皮肤变紧	zhengzhuang/jbpfbj/
局部软组织浸润	zhengzhuang/jbrzzjr/
局部头痛	zhengzhuang/jbtt_2177/
局部压痛	zhengzhuang/jbyt/
局部游走性红斑	zhengzhuang/jbyzxhb/
局部肢体抽动	zhengzhuang/jbztcd/
局部灼热	zhengzhuang/jbzr/
局限性肌张力障碍	zhengzhuang/jxxjzlza/
局限性肾坏死	zhengzhuang/jxxshs/
局灶症状	zhengzhuang/jzzz/
咀嚼肌肥大	zhengzhuang/jjjfd/
咀嚼肌痉挛	zhengzhuang/jjjjl/
沮丧	zhengzhuang/js_2187/
巨肠症	zhengzhuang/jcz/
巨大膀胱	zhengzhuang/jdbg/
巨大的结肠	zhengzhuang/jddjc/
巨大颅骨缺损	zhengzhuang/jdlgqs/
巨痕症	zhengzhuang/jhz/
巨脚	zhengzhuang/jj_2193/
巨口	zhengzhuang/jk/
巨脾症	zhengzhuang/jpz/
巨乳	zhengzhuang/jr/
巨舌	zhengzhuang/js_2197/
巨输尿管症	zhengzhuang/jsngz/
巨胃窦症	zhengzhuang/jwdz/
巨阴症	zhengzhuang/jyz/
巨指(趾)	zhengzhuang/jz_z_/
巨痣症	zhengzhuang/jzz_2202/
拒食	zhengzhuang/js_2203/
剧烈神经根性痛	zhengzhuang/jlsjgxt/
剧烈疼痛	zhengzhuang/jltt/
剧烈头痛	zhengzhuang/jltt_2206/
剧烈眩晕，站立不稳	zhengzhuang/jlxy_zlbw/
剧烈运动后呕吐	zhengzhuang/jlydhot/
剧烈运动后头晕	zhengzhuang/jlydhty/
剧烈运动后腰痛	zhengzhuang/jlydhyt/
剧烈运动或强体力劳动后血尿	zhengzhuang/jlydhqtlldhxn/
剧痛	zhengzhuang/jt_2212/
剧痒	zhengzhuang/jy_2213/
剧痒的疣状结节	zhengzhuang/jydyzjj/
惧站立，喜依托	zhengzhuang/jzl_xyt/
距骨坏死	zhengzhuang/jghs/
聚合性痤疮	zhengzhuang/jhxcc/
决断困难感	zhengzhuang/jdkng/
绝汗	zhengzhuang/jh/
绝经	zhengzhuang/jj_2220/
绝经过渡期及绝经后闭经	zhengzhuang/jjgdqjjjhbj/
绝经后白带增多	zhengzhuang/jjhbdzd/
绝经后出血	zhengzhuang/jjhcx/
绝经后子宫内膜增厚	zhengzhuang/jjhzgnmzh/
绝经年龄过迟	zhengzhuang/jjnlgc/
绝经年龄过早	zhengzhuang/jjnlgz/
绝经期面红	zhengzhuang/jjqmh/
绝望感	zhengzhuang/jwg/
觉醒状态丧失	zhengzhuang/jxztss/
均小型狭窄	zhengzhuang/jxxxz/
菌尿	zhengzhuang/jn/
菌血症	zhengzhuang/jxz/
脐部有一半球形肿块	zhengzhuang/qbyybqxzk/
脐带过短或相对过短	zhengzhuang/qdgdhxdgd/
脐带脱落后伤口不愈并溢液	zhengzhuang/qdtlhskbybyy/
脐带血流	zhengzhuang/qdxl/
脐带血循环障碍	zhengzhuang/qdxxhza/
脐尿管残余	zhengzhuang/qngcy/
脐窝湿润有臭味	zhengzhuang/qwsrycw/
脐周腹壁缺损	zhengzhuang/qzfbqs/
脐周皮肤青紫色斑	zhengzhuang/qzpfqzsb/
脐周围褪色	zhengzhuang/qzwts/
脐周肿胀	zhengzhuang/qzzz/
伤口结疤	zhengzhuang/skjb/
胎儿酒精影响	zhengzhuang/tejjyx/
糖激素依赖	zhengzhuang/tjsyl/
限局性巩膜膨隆肿物	zhengzhuang/xjxgmplzw/
“咳嗽水”上瘾	zhengzhuang/_kss_sy/
Korsakov综合征	zhengzhuang/korsakovzhz/
咖啡斑	zhengzhuang/kfb/
开放性神经管缺陷	zhengzhuang/kfxsjgqx/
开放性损伤	zhengzhuang/kfxss/
开睑及闭睑失用	zhengzhuang/kjjbjsy/
看不到脚尖步行困难	zhengzhuang/kbdjjbxkn/
看东西变远	zhengzhuang/kdxby/
看东西有小黑点	zhengzhuang/kdxyxhd/
看东西有重影	zhengzhuang/kdxyzy/
抗-HCVAg阳性	zhengzhuang/k_hcvagyx/
抗Jo-1抗体阳性	zhengzhuang/kjo_1ktyx/
抗感染能力下降	zhengzhuang/kgrnlxj/
抗精子抗体阳性	zhengzhuang/kjzktyx/
抗利尿激素(ADH)分泌减少	zhengzhuang/klnjs_adh_fmjs/
抗利尿激素(ADH)分泌增多	zhengzhuang/klnjs_adh_fmzd/
抗卵巢抗体阳性	zhengzhuang/klcktyx/
抗内膜抗体阳性	zhengzhuang/knmktyx/
考试焦虑	zhengzhuang/ksjl/
考试综合症	zhengzhuang/kszhz/
咳出带臭味的干痂	zhengzhuang/kcdcwdgj/
咳出黄色痰液	zhengzhuang/kchsty/
咳出棕色痰栓	zhengzhuang/kczsts/
咳泡沫黏液痰	zhengzhuang/kpmnyt/
咳巧克力色痰	zhengzhuang/kqklst/
咳声嘶哑	zhengzhuang/kssy/
咳嗽	zhengzhuang/ks/
咳嗽伴杵状指	zhengzhuang/ksbczz/
咳嗽伴呼吸困难	zhengzhuang/ksbhxkn/
咳嗽伴体重减轻	zhengzhuang/ksbtzjq/
咳嗽伴哮鸣音	zhengzhuang/ksbxmy/
咳嗽伴胸痛	zhengzhuang/ksbxt/
咳嗽反射	zhengzhuang/ksfs/
咳嗽性晕厥	zhengzhuang/ksxyj/
咳痰	zhengzhuang/kt/
咳铁锈色痰	zhengzhuang/ktxst/
咳血	zhengzhuang/kx/
吐血痰	zhengzhuang/txt/
可逆性氮质血症	zhengzhuang/knxdzxz/
克汀病面容	zhengzhuang/ktbmr/
空肠憩室	zhengzhuang/kcqs/
空洞形成	zhengzhuang/kdxc/
空腹低血糖	zhengzhuang/kfdxt/
空腹时腹部有振水声者	zhengzhuang/kfsfbyzssz/
空间感知障碍	zhengzhuang/kjgzza/
空气栓塞	zhengzhuang/kqss/
空虚症	zhengzhuang/kxz/
恐风	zhengzhuang/kf/
恐惧	zhengzhuang/kj/
恐水症	zhengzhuang/ksz/
控制不住的联想	zhengzhuang/kzbzdlx/
控制能力丧失	zhengzhuang/kznlss/
芤脉	zhengzhuang/km/
口、眼、生殖器损害	zhengzhuang/k_y_szqsh/
口鼻生疮	zhengzhuang/kbsc/
口鼻血性分泌物	zhengzhuang/kbxxfmw/
口鼻周围发绀	zhengzhuang/kbzwfg/
口吃	zhengzhuang/kc/
口齿不清	zhengzhuang/kcbq/
口齿含糊	zhengzhuang/kchh/
口臭	zhengzhuang/kc_2308/
口唇苍白	zhengzhuang/kccb/
口唇常无力而不能鼓气	zhengzhuang/kccwlebngq/
口唇潮红	zhengzhuang/kcch/
口唇出血	zhengzhuang/kccx/
口唇刺痛	zhengzhuang/kcct/
口唇发绀	zhengzhuang/kcfg/
口唇发黄	zhengzhuang/kcfh/
口唇泛黑	zhengzhuang/kcfh_2316/
口唇泛红	zhengzhuang/kcfh_2317/
口唇干燥	zhengzhuang/kcgz/
口唇和甲床略带青紫	zhengzhuang/kchjcldqz/
口唇皲裂	zhengzhuang/kcjl/
口唇麻木	zhengzhuang/kcmm/
口唇疱疹	zhengzhuang/kcpz/
口唇青紫	zhengzhuang/kcqz/
口唇渗液	zhengzhuang/kcsy/
口唇严重充血呈红色	zhengzhuang/kcyzcxchs/
口唇周围麻木感刺痛	zhengzhuang/kczwmmgct/
口唇周围有炎性鳞状皮肤	zhengzhuang/kczwyyxlzpf/
口淡黏腻	zhengzhuang/kdnn/
口淡无味	zhengzhuang/kdww/
口干	zhengzhuang/kg/
口干渴难忍	zhengzhuang/kgknr/
口干舌燥	zhengzhuang/kgsz/
口及咽部烧灼感	zhengzhuang/kjybszg/
口角和鼻周出现黄白色水疱	zhengzhuang/kjhbzcxhbssp/
口角肌肉的抽搐	zhengzhuang/kjjrdcc/
口角皲裂	zhengzhuang/kjjl/
口角生疮	zhengzhuang/kjsc/
口角歪斜，无法说话	zhengzhuang/kjwx_wfsh/
口角下垂	zhengzhuang/kjxc/
口角向外的放射性皱纹	zhengzhuang/kjxwdfsxzw/
口渴感丧失	zhengzhuang/kkgss/
口苦	zhengzhuang/kk/
口辣	zhengzhuang/kl/
口腔唇系带粗大	zhengzhuang/kqcxdcd/
口腔幻触	zhengzhuang/kqhc/
口腔溃疡	zhengzhuang/kqky/
口腔难愈的白色片状物	zhengzhuang/kqnydbspzw/
口腔黏膜白斑	zhengzhuang/kqnmbb/
口腔黏膜呈现青紫色	zhengzhuang/kqnmcxqzs/
口腔黏膜黄豆大小，半透明的无痛小疱	zhengzhuang/kqnmhddx_btmdwtxp/
口腔黏膜溃疡	zhengzhuang/kqnmky/
口腔黏膜脱落	zhengzhuang/kqnmtl/
口腔黏膜纤维化	zhengzhuang/kqnmxwh/
口腔念珠菌感染	zhengzhuang/kqnzjgr/
口腔痛	zhengzhuang/kqt/
口腔血泡	zhengzhuang/kqxp/
口腔粘膜弥漫充血	zhengzhuang/kqzmmmcx/
口腔粘膜色素沉着	zhengzhuang/kqzmsscz/
口腔粘膜上白色较硬的隆起斑块	zhengzhuang/kqzmsbsjydlqbk/
口腔粘膜有形似奶块的斑膜	zhengzhuang/kqzmyxsnkdbm/
口涩	zhengzhuang/ks_2361/
口舌生疮	zhengzhuang/kssc/
口酸	zhengzhuang/ks_2363/
口酸伴有口苦烧心	zhengzhuang/ksbykksx/
口甜	zhengzhuang/kt_2365/
口痛	zhengzhuang/kt_2366/
口吐白沫	zhengzhuang/ktbm/
口咸	zhengzhuang/kx_2368/
口香	zhengzhuang/kx_2369/
口咽部水疱状损害	zhengzhuang/kybspzsh/
口咽异物	zhengzhuang/kyyw/
口炎	zhengzhuang/ky/
口有溴味及咸味	zhengzhuang/kyxwjxw/
口粘腻	zhengzhuang/kzn/
口中有金属甜味	zhengzhuang/kzyjstw/
寇热	zhengzhuang/kr/
哭泣样尖叫	zhengzhuang/kqyjj/
哭泣晕厥	zhengzhuang/kqyj/
哭笑失常	zhengzhuang/kxsc/
苦笑面容	zhengzhuang/kxmr/
库欣综合征	zhengzhuang/kxzhz/
夸大狂	zhengzhuang/kdk/
跨阈步态	zhengzhuang/kybt/
块状痰	zhengzhuang/kzt/
快感缺乏	zhengzhuang/kgqf/
髋、膝、肘部呈屈曲畸形	zhengzhuang/k_x_zbcqqjx/
髋部酸胀不适	zhengzhuang/kbszbs/
髋关节发育不良	zhengzhuang/kgjfybl/
髋关节积液	zhengzhuang/kgjjy/
髋关节痛	zhengzhuang/kgjt/
髋关节脱位	zhengzhuang/kgjtw/
髋内翻	zhengzhuang/knf/
髋外侧可见皮下瘀血斑	zhengzhuang/kwckjpxyxb/
髋外侧酸胀	zhengzhuang/kwcsz/
髋外侧肿胀压痛	zhengzhuang/kwczzyt/
狂笑	zhengzhuang/kx_2396/
眶底爆折	zhengzhuang/kdbz/
眶静脉回流障碍	zhengzhuang/kjmhlza/
眶周青紫	zhengzhuang/kzqz/
眶周水肿	zhengzhuang/kzsz/
眶周瘀斑	zhengzhuang/kzyb/
窥淫癖	zhengzhuang/kyp/
溃疡	zhengzhuang/ky_2403/
溃疡穿孔或出血	zhengzhuang/kyckhcx/
溃疡分泌物恶臭	zhengzhuang/kyfmwec/
溃疡龛影	zhengzhuang/kyky/
溃疡疼痛	zhengzhuang/kytt/
溃疡外观呈菜花样	zhengzhuang/kywgcchy/
溃疡外观呈虫蚀样	zhengzhuang/kywgccsy/
溃疡外观呈火山口样	zhengzhuang/kywgchsky/
阔韧带内形成血肿	zhengzhuang/krdnxcxz/
咯多量血性泡沫痰	zhengzhuang/kdlxxpmt/
露出骨头的骨折	zhengzhuang/lcgtdgz/
躁狂与昏睡交替	zhengzhuang/zkyhsjt/
“老练”外貌	zhengzhuang/_ll_wm/
睑结膜充血露出黄色脓块	zhengzhuang/jjmcxlchsnk/
睑结膜出现灰白色膜	zhengzhuang/jjmcxhbsm/
睑结膜泪阜区灰黑色肿物	zhengzhuang/jjmlfqhhszw/
睑结膜沙粒外观	zhengzhuang/jjmslwg/
睑裂狭小	zhengzhuang/jlxx/
眶上裂综合征	zhengzhuang/kslzhz/
腊肠趾	zhengzhuang/lcz/
阑尾壁缺血坏死	zhengzhuang/lwbqxhs/
阑尾穿孔	zhengzhuang/lwck/
阑尾感染	zhengzhuang/lwgr/
阑尾脓肿	zhengzhuang/lwnz/
阑尾腔闭塞	zhengzhuang/lwqbs/
阑尾缺血充血	zhengzhuang/lwqxcx/
阑尾周围脓肿	zhengzhuang/lwzwnz/
阑尾组织纤维化	zhengzhuang/lwzzxwh/
蓝巩膜	zhengzhuang/lgm/
蓝鼓膜征	zhengzhuang/lgmz/
蓝黄色盲	zhengzhuang/lhsm/
蓝黄色弱	zhengzhuang/lhsr/
蓝色、蓝灰色或蓝黑色丘疹	zhengzhuang/ls_lhshlhsqz/
蓝色视野缺损	zhengzhuang/lssyqs/
蓝色橡皮大疱痣	zhengzhuang/lsxpdpz/
懒胆囊	zhengzhuang/ldn/
烂桃样血痰	zhengzhuang/ltyxt/
烂眼边	zhengzhuang/lyb/
劳动后气急	zhengzhuang/ldhqj/
劳动耐力下降	zhengzhuang/ldnlxj/
劳累后感觉胸闷	zhengzhuang/llhgjxm/
劳累后心悸	zhengzhuang/llhxj/
劳累后胸痛	zhengzhuang/llhxt/
劳累后遗精	zhengzhuang/llhyj/
劳累时腰部酸痛或胀痛	zhengzhuang/llsybsthzt/
劳力性呼吸困难	zhengzhuang/llxhxkn/
劳力性晕厥	zhengzhuang/llxyj/
牢脉	zhengzhuang/lm/
老化松弛性眼袋	zhengzhuang/lhscxyd/
老来瘦	zhengzhuang/lls/
老年妇女乳房增大	zhengzhuang/lnfnrfzd/
老年男性乳房无痛性肿块	zhengzhuang/lnnxrfwtxzk/
老年人非病变性眼前飞蚊	zhengzhuang/lnrfbbxyqfw/
老年人高粘血症	zhengzhuang/lnrgzxz/
老年人流泪多	zhengzhuang/lnrlld/
老年人腿抽筋	zhengzhuang/lnrtcj/
老年人小腿浮肿	zhengzhuang/lnrxtfz/
老年性眩晕	zhengzhuang/lnxxy/
老年性震颤	zhengzhuang/lnxzc/
老人便秘	zhengzhuang/lrbm/
老人剧烈咳嗽	zhengzhuang/lrjlks/
老人髋部疼痛	zhengzhuang/lrkbtt/
老人行动迟缓	zhengzhuang/lrxdch/
老人性格孤僻	zhengzhuang/lrxggp/
酪氨酸血症	zhengzhuang/lasxz/
肋骨及胸骨下吸入性凹陷	zhengzhuang/lgjxgxxrxax/
肋骨融合	zhengzhuang/lgrh/
肋骨痛	zhengzhuang/lgt/
肋间肩胛带疼痛	zhengzhuang/ljjjdtt/
肋间神经痛	zhengzhuang/ljsjt/
肋间隙变窄	zhengzhuang/ljxbz/
肋间隙可有压痛	zhengzhuang/ljxkyyt/
肋膜腔积水	zhengzhuang/lmqjs/
肋痛	zhengzhuang/lt/
泪道阻塞	zhengzhuang/ldzs/
泪膜消失	zhengzhuang/lmxs/
泪腺不发达	zhengzhuang/lxbfd/
泪腺发炎	zhengzhuang/lxfy/
泪腺汗腺及涎腺等先分泌增多而后减少	zhengzhuang/lxhxjxxdxfmzdehjs/
泪腺囊肿	zhengzhuang/lxnz/
泪腺脱垂	zhengzhuang/lxtc/
泪腺肿大	zhengzhuang/lxzd/
泪液、唾液及汗液分泌减少或消失	zhengzhuang/ly_tyjhyfmjshxs/
泪溢	zhengzhuang/ly/
类癌面红	zhengzhuang/lamh/
类癌综合征	zhengzhuang/lazhz/
类风湿关节炎	zhengzhuang/lfsgjy/
类戒断反应	zhengzhuang/ljdfy/
类偏狂	zhengzhuang/lpk/
类人猿型骨盆	zhengzhuang/lryxgp/
类似荨麻疹的皮肤潮红斑块	zhengzhuang/lsqmzdpfchbk/
累及整个腹腔的腹膜炎	zhengzhuang/ljzgfqdfmy/
冷汗	zhengzhuang/lh/
冷汗淋漓	zhengzhuang/lhll/
冷结节	zhengzhuang/ljj/
冷球蛋白发生沉淀或呈胶冻状	zhengzhuang/lqdbfscdhcjdz/
冷球蛋白血症	zhengzhuang/lqdbxz/
冷热交替	zhengzhuang/lrjt/
里急后重	zhengzhuang/ljhz/
立毛反射减弱	zhengzhuang/lmfsjr/
立毛反射亢进	zhengzhuang/lmfskj/
立卧心率差数	zhengzhuang/lwxlcs/
利尿	zhengzhuang/ln/
沥青烧伤	zhengzhuang/lqss/
粒细胞减少	zhengzhuang/lxbjs/
痢疾	zhengzhuang/lj/
痢疾样大便	zhengzhuang/ljydb/
连枷胸	zhengzhuang/ljx/
连续机器样杂音	zhengzhuang/lxjqyzy/
联合瓣膜脱垂	zhengzhuang/lhbmtc/
联想障碍	zhengzhuang/lxza/
脸部大小不一	zhengzhuang/lbdxby/
脸部疼痛	zhengzhuang/lbtt/
脸冻伤	zhengzhuang/lds/
脸红	zhengzhuang/lh_2517/
脸颊潮红	zhengzhuang/ljch/
脸颊出现红血丝	zhengzhuang/ljcxhxs/
脸颊发灰	zhengzhuang/ljfh/
脸裂	zhengzhuang/ll/
脸色发黑	zhengzhuang/lsfh/
脸色发黄	zhengzhuang/lsfh_2523/
脸上长斑	zhengzhuang/lscb/
脸上黑斑	zhengzhuang/lshb/
恋爱挫折综合征	zhengzhuang/laczzhz/
恋毛巾被癖	zhengzhuang/lmjbp/
恋尸型性变态	zhengzhuang/lsxxbt/
恋兽型性变态	zhengzhuang/lsxxbt_2529/
良性反应性改变	zhengzhuang/lxfyxgb/
良性假肥大型肌营养不良症	zhengzhuang/lxjfdxjyyblz/
良性溃疡改变	zhengzhuang/lxkygb/
凉结节	zhengzhuang/ljj_2533/
两臂不能上举而成垂肩	zhengzhuang/lbbnsjeccj/
两侧颊部及颞部凹入	zhengzhuang/lcjbjnbar/
两肺满布粟粒状阴影	zhengzhuang/lfmbslzyy/
两肺毛玻璃样粟粒样或结节样改变	zhengzhuang/lfmblyslyhjjygb/
两肺弥漫或散在可逆性哮鸣音	zhengzhuang/lfmmhszknxxmy/
两手颤抖	zhengzhuang/lscd/
两条腿不一样长	zhengzhuang/lttbyyc/
两下肺纹理增粗	zhengzhuang/lxfwlzc/
两性畸形	zhengzhuang/lxjx/
两眼干涩	zhengzhuang/lygs/
两眼上视障碍	zhengzhuang/lyssza/
两眼下视不能	zhengzhuang/lyxsbn/
裂腭	zhengzhuang/le/
临产后俯屈不良	zhengzhuang/lchfqbl/
临产后胎头衔接较晚	zhengzhuang/lchttxjjw/
临产后阵痛剧烈	zhengzhuang/lchztjl/
淋巴道转移	zhengzhuang/lbdzy/
淋巴发育不全	zhengzhuang/lbfybq/
淋巴管破裂	zhengzhuang/lbgpl/
淋巴管淤积	zhengzhuang/lbgyj/
淋巴结充血	zhengzhuang/lbjcx/
淋巴结穿刺有草黄色清亮液体	zhengzhuang/lbjccychsqlyt/
淋巴结结核	zhengzhuang/lbjjh/
淋巴结疼痛	zhengzhuang/lbjtt/
淋巴结退化	zhengzhuang/lbjth/
淋巴结肿大	zhengzhuang/lbjzd/
淋巴液流出	zhengzhuang/lbylc/
淋巴增生	zhengzhuang/lbzs/
磷烧伤合并中毒	zhengzhuang/lsshbzd/
鳞屑	zhengzhuang/lx/
鳞状上皮	zhengzhuang/lzsp/
鳞状细胞癌	zhengzhuang/lzxba/
鳞状细胞化生	zhengzhuang/lzxbhs/
菱形-现象	zhengzhuang/lx_xx/
流鼻涕	zhengzhuang/lbt/
流鼻血	zhengzhuang/lbx/
流产	zhengzhuang/lc/
流感样症状	zhengzhuang/lgyzz/
流黄鼻涕	zhengzhuang/lhbt/
流泪	zhengzhuang/ll_2573/
流清涕	zhengzhuang/lqt/
流涎	zhengzhuang/lx_2575/
流行性肌痛	zhengzhuang/lxxjt/
瘤体坚硬	zhengzhuang/ltjy/
瘤体牵拉	zhengzhuang/ltql/
瘤细胞浸润	zhengzhuang/lxbjr/
咯血	zhengzhuang/kx_2580/
咯血伴发热	zhengzhuang/kxbfr/
咯血伴黄疸	zhengzhuang/kxbhd/
咯血伴呛咳	zhengzhuang/kxbqk/
咯血伴胸痛	zhengzhuang/kxbxt/
咯血伴有皮肤粘膜出血	zhengzhuang/kxbypfzmcx/
漏斗骨盆	zhengzhuang/ldgp/
露阴癖	zhengzhuang/lyp/
颅底畸形	zhengzhuang/ldjx/
颅缝过早闭合	zhengzhuang/lfgzbh/
颅骨骨折	zhengzhuang/lggz/
颅骨连续性中断	zhengzhuang/lglxxzd/
颅骨增生	zhengzhuang/lgzs/
颅面骨畸形	zhengzhuang/lmgjx/
颅内出血	zhengzhuang/lncx/
颅内钙化	zhengzhuang/lngh/
颅内感染	zhengzhuang/lngr/
颅内高压	zhengzhuang/lngy/
颅内头痛	zhengzhuang/lntt/
颅内压增高	zhengzhuang/lnyzg/
颅内占位性病变	zhengzhuang/lnzwxbb/
颅脑损伤后头痛	zhengzhuang/lnsshtt/
颅神经麻痹	zhengzhuang/lsjmb/
颅神经损害	zhengzhuang/lsjsh/
颅外头痛	zhengzhuang/lwtt/
颅压增高	zhengzhuang/lyzg/
滤泡增大	zhengzhuang/lpzd/
旅行者水肿	zhengzhuang/lxzsz/
绿色盲	zhengzhuang/lsm/
绿色尿	zhengzhuang/lsn/
绿色弱	zhengzhuang/lsr/
绿视	zhengzhuang/ls/
绿牙或棕褐色牙	zhengzhuang/lyhzhsy/
挛缩性疤痕	zhengzhuang/lsxbh/
挛缩性瘢痕	zhengzhuang/lsxbh_2614/
卵巢功能障碍	zhengzhuang/lcgnza/
卵巢囊肿	zhengzhuang/lcnz/
卵巢缺如或发育不全	zhengzhuang/lcqrhfybq/
卵巢性闭经	zhengzhuang/lcxbj/
卵巢性多毛	zhengzhuang/lcxdm/
卵泡刺激素(FSH)增高	zhengzhuang/lpcjs_fsh_zg/
卵泡囊肿	zhengzhuang/lpnz/
卵圆孔闭合不全	zhengzhuang/lykbhbq/
卵圆窝未闭	zhengzhuang/lywwb/
啰音	zhengzhuang/ly_2624/
螺旋形骨折	zhengzhuang/lxxgz/
落枕	zhengzhuang/lz/
面部半球形蓝黑色结节	zhengzhuang/mbbqxlhsjj/
面部浮肿	zhengzhuang/mbfz/
男性化	zhengzhuang/nxh/
囟门闭合晚	zhengzhuang/xmbhw/
囟门跳动	zhengzhuang/xmtd/
Moro反应迟钝	zhengzhuang/morofycd/
麻痹	zhengzhuang/mb/
麻痹性肠梗阻	zhengzhuang/mbxcgz/
麻风恐怖	zhengzhuang/mfkb/
麻疹面容	zhengzhuang/mzmr/
麻醉药中毒	zhengzhuang/mzyzd/
马蹄内翻足	zhengzhuang/mtnfz/
马蹄外翻足	zhengzhuang/mtwfz/
马尾损伤	zhengzhuang/mwss/
埋藏齿	zhengzhuang/mcc/
脉搏短绌	zhengzhuang/mbdc/
脉搏加速	zhengzhuang/mbjs/
脉搏快而弱	zhengzhuang/mbker/
脉搏脱漏	zhengzhuang/mbtl/
脉搏细弱甚至不能清楚触及	zhengzhuang/mbxrszbnqccj/
脉搏细速	zhengzhuang/mbxs/
脉沉缓或沉细	zhengzhuang/mchhcx/
脉缓	zhengzhuang/mh/
脉率增快	zhengzhuang/mlzk/
脉络膜凹陷	zhengzhuang/mlmax/
脉数	zhengzhuang/ms/
脉速而无力	zhengzhuang/msewl/
脉压差大	zhengzhuang/mycd/
脉压差低	zhengzhuang/mycd_2655/
脉压缩小	zhengzhuang/mysx/
脉压小	zhengzhuang/myx/
脉压增宽	zhengzhuang/myzk/
脉氧合不足	zhengzhuang/myhbz/
满月脸	zhengzhuang/myl/
慢性房颤	zhengzhuang/mxfc/
慢性腹痛	zhengzhuang/mxft/
慢性静脉功能不全	zhengzhuang/mxjmgnbq/
慢性咳嗽	zhengzhuang/mxks/
慢性溃疡	zhengzhuang/mxky/
慢性面容	zhengzhuang/mxmr/
慢性盆腔痛	zhengzhuang/mxpqt/
慢性贫血	zhengzhuang/mxpx/
慢性肾功能不全	zhengzhuang/mxsgnbq/
慢性肾衰竭	zhengzhuang/mxssj/
慢性肾损害	zhengzhuang/mxssh/
慢性湿疹样变	zhengzhuang/mxszyb/
慢性头痛	zhengzhuang/mxtt/
慢性胃痛	zhengzhuang/mxwt/
慢性腰痛伴下肢麻痛	zhengzhuang/mxytbxzmt/
盲袋阴道	zhengzhuang/mdyd/
盲点	zhengzhuang/md/
猫喘音	zhengzhuang/mcy/
毛发呈脱发祥	zhengzhuang/mfctfx/
毛发干枯	zhengzhuang/mfgk/
毛发干燥易断	zhengzhuang/mfgzyd/
毛发脱落	zhengzhuang/mftl/
毛发稀少	zhengzhuang/mfxs/
毛发异常	zhengzhuang/mfyc/
毛发增多	zhengzhuang/mfzd/
毛发增生	zhengzhuang/mfzs/
毛孔粗大	zhengzhuang/mkcd/
毛孔堵塞	zhengzhuang/mkds/
毛孔角化过度	zhengzhuang/mkjhgd/
毛囊角栓	zhengzhuang/mnjs/
毛囊性呈鳞片状角化	zhengzhuang/mnxclpzjh/
毛细血管搏动	zhengzhuang/mxxgbd/
毛细血管出血	zhengzhuang/mxxgcx/
毛细血管扩张症	zhengzhuang/mxxgkzz/
毛细血管渗漏综合征	zhengzhuang/mxxgslzhz/
没有肛门	zhengzhuang/mygm/
玫瑰疹	zhengzhuang/mgz/
眉弓凹陷	zhengzhuang/mgax/
眉弓囊肿	zhengzhuang/mgnz/
眉弓疼痛	zhengzhuang/mgtt/
眉间皱纹	zhengzhuang/mjzw/
眉毛变白	zhengzhuang/mmbb/
眉毛外侧脱落稀疏而细	zhengzhuang/mmwctlxsex/
眉下垂或位置低	zhengzhuang/mxchwzd/
梅毒肝	zhengzhuang/mdg/
梅毒感染	zhengzhuang/mdgr/
梅毒恐怖	zhengzhuang/mdkb/
梅毒性脱发	zhengzhuang/mdxtf/
煤尘或胆固醇结晶的黏痰	zhengzhuang/mchdgcjjdnt/
霉菌感染	zhengzhuang/mjgr/
门齿间距增宽	zhengzhuang/mcjjzk/
门静脉积气	zhengzhuang/mjmjq/
门静脉血流郁滞	zhengzhuang/mjmxlyz/
门脉高压	zhengzhuang/mmgy/
门体侧支循环	zhengzhuang/mtczxh/
门体侧支循环的形成	zhengzhuang/mtczxhdxc/
门诊高血压	zhengzhuang/mzgxy/
萌牙延迟	zhengzhuang/myyc/
梦幻觉	zhengzhuang/mhj/
梦行症	zhengzhuang/mxz/
梦游症	zhengzhuang/myz/
弥漫性出血	zhengzhuang/mmxcx/
弥漫性腹部骨化	zhengzhuang/mmxfbgh/
弥漫性骨膜增厚	zhengzhuang/mmxgmzh/
弥漫性骨质疏松	zhengzhuang/mmxgzss/
弥漫性鼓音	zhengzhuang/mmxgy/
弥漫性脐周疼痛	zhengzhuang/mmxqztt/
弥漫性头痛	zhengzhuang/mmxtt/
弥漫性系膜硬化	zhengzhuang/mmxxmyh/
弥漫性下腰痛	zhengzhuang/mmxxyt/
弥漫性血管角化	zhengzhuang/mmxxgjh/
弥漫性脂肪变性	zhengzhuang/mmxzfbx/
迷恋足部或鞋袜	zhengzhuang/mlzbhxw/
迷走神经兴奋	zhengzhuang/mzsjxf/
迷走神经张力增高	zhengzhuang/mzsjzlzg/
泌尿道破裂	zhengzhuang/mndpl/
泌尿道狭窄	zhengzhuang/mndxz/
泌尿道阻塞	zhengzhuang/mndzs/
泌尿生殖窦	zhengzhuang/mnszd/
泌尿系感染	zhengzhuang/mnxgr/
泌乳障碍	zhengzhuang/mrza/
免疫功能障碍	zhengzhuang/mygnza/
免疫力降低	zhengzhuang/myljd/
免疫力下降	zhengzhuang/mylxj/
免疫缺陷	zhengzhuang/myqx/
免疫损害	zhengzhuang/mysh/
免疫性溶血	zhengzhuang/myxrx/
免疫性肾炎	zhengzhuang/myxsy/
面、颈部味觉性多汗	zhengzhuang/m_jbwjxdh/
面、头、颈、肩发作性剧痛	zhengzhuang/m_t_j_jfzxjt/
面部斑点	zhengzhuang/mbbd/
面部蝶形红斑	zhengzhuang/mbdxhb/
面部多毛	zhengzhuang/mbdm/
面部肌肉痉挛	zhengzhuang/mbjrjl/
面部畸形	zhengzhuang/mbjx/
面部叩击征	zhengzhuang/mbkjz/
面部麻木	zhengzhuang/mbmm/
面部皮肤油腻	zhengzhuang/mbpfyn/
面部皮肤有结节状增生	zhengzhuang/mbpfyjjzzs/
面部皮肤皱纹增多	zhengzhuang/mbpfzwzd/
面部闪电疼痛	zhengzhuang/mbsdtt/
面部脱皮	zhengzhuang/mbtp/
面部血管纤维瘤	zhengzhuang/mbxgxwl/
面部一侧出汗另一侧却无汗	zhengzhuang/mbycchlycqwh/
面长耳大	zhengzhuang/mced/
面肌抽搐	zhengzhuang/mjcc/
面肌及颈肌紧张	zhengzhuang/mjjjjjz/
面肌强直	zhengzhuang/mjqz/
面肌萎缩	zhengzhuang/mjws/
面肌无力	zhengzhuang/mjwl/
面颊及上胸部充血	zhengzhuang/mjjsxbcx/
面颊明显内陷	zhengzhuang/mjmxnx/
面具脸	zhengzhuang/mjl/
面容呈灰色	zhengzhuang/mrchs/
面容憔悴早老	zhengzhuang/mrqczl/
面容失认	zhengzhuang/mrsr/
面色苍白	zhengzhuang/mscb/
面色潮红	zhengzhuang/msch/
面色灰暗	zhengzhuang/msha/
面色青灰	zhengzhuang/msqh/
面色青紫	zhengzhuang/msqz/
面神经瘫痪	zhengzhuang/msjth/
面痛	zhengzhuang/mt/
面纹消失	zhengzhuang/mwxs/
面下部头痛	zhengzhuang/mxbtt/
酩酊感	zhengzhuang/mdg_2786/
摸空症	zhengzhuang/mkz/
摸索反射	zhengzhuang/msfs/
模仿性自动症	zhengzhuang/mfxzdz/
模仿言语	zhengzhuang/mfyy/
模糊不定，情绪性面痛	zhengzhuang/mhbd_qxxmt/
摩擦型性变态	zhengzhuang/mcxxbt/
磨牙	zhengzhuang/my/
磨牙后垫红肿	zhengzhuang/myhdhz/
末梢神经炎	zhengzhuang/mssjy/
末指短小向内弯曲或只有两指节	zhengzhuang/mzdxxnwqhzylzj/
母婴ABO血型不合	zhengzhuang/myaboxxbh/
拇、食、中三指有放射痛	zhengzhuang/m_s_zszyfst/
拇食指捏物功能障碍	zhengzhuang/msznwgnza/
拇外翻	zhengzhuang/mwf/
拇指半月甲呈粉红色时	zhengzhuang/mzbyjcfhss/
拇指不明原因疼痛	zhengzhuang/mzbmyytt/
拇指和食指不能对掌成完好的“O”形	zhengzhuang/mzhszbndzcwhd_o_x/
拇指仅存软组织而无骨骼	zhengzhuang/mzjcrzzewgg/
拇指内收畸形	zhengzhuang/mznsjx/
拇指三节	zhengzhuang/mzsj/
拇指征	zhengzhuang/mzz/
拇趾与二趾趾间距大	zhengzhuang/mzyezzjjd/
木僵	zhengzhuang/mj/
目赤	zhengzhuang/mc/
目垢增多	zhengzhuang/mgzd/
目光呆滞	zhengzhuang/mgdz/
目痛	zhengzhuang/mt_2813/
尿流呈波动状	zhengzhuang/nlcbdz/
细胞酶活性异常	zhengzhuang/xbmhxyc/
电脑失写症	zhengzhuang/dnsxz/
内出血	zhengzhuang/ncx/
内毒素血症	zhengzhuang/ndsxz/
内分泌功能减退	zhengzhuang/nfmgnjt/
内分泌功能亢进	zhengzhuang/nfmgnkj/
内踝下区域疼痛肿胀	zhengzhuang/nhxqyttzz/
内容难以听清的自言自语	zhengzhuang/nrnytqdzyzy/
内收型骨折	zhengzhuang/nsxgz/
内向性思维	zhengzhuang/nxxsw/
内斜A征	zhengzhuang/nxaz/
内斜V征	zhengzhuang/nxvz/
内脏出血	zhengzhuang/nzcx/
内脏梗阻	zhengzhuang/nzgz/
内脏痛	zhengzhuang/nzt/
内脏性肥胖	zhengzhuang/nzxfp/
纳差	zhengzhuang/nc/
耐热力降低	zhengzhuang/nrljd/
男型骨盆	zhengzhuang/nxgp/
男性不育	zhengzhuang/nxby/
男性乳房大	zhengzhuang/nxrfd/
男性小便刺痛	zhengzhuang/nxxbct/
男性小腹痛	zhengzhuang/nxxft/
男性小腹坠痛	zhengzhuang/nxxfzt/
男性型肥胖	zhengzhuang/nxxfp/
男性性早熟	zhengzhuang/nxxzs/
男子性功能障碍	zhengzhuang/nzxgnza/
难免流产或不可避免流产	zhengzhuang/nmlchbkbmlc/
难免早产	zhengzhuang/nmzc/
难入睡或易惊醒	zhengzhuang/nrshyjx/
难治性腹水	zhengzhuang/nzxfs/
难治性溃疡	zhengzhuang/nzxky/
难治性贫血	zhengzhuang/nzxpx/
喃喃重复自语	zhengzhuang/nnzfzy/
囊性坏死	zhengzhuang/nxhs/
囊性肿块	zhengzhuang/nxzk/
囊样斑块	zhengzhuang/nybk/
囊肿	zhengzhuang/nz/
囊肿壁薄且内含无色液体	zhengzhuang/nzbbqnhwsyt/
囊肿性痤疮	zhengzhuang/nzxcc/
囊肿样改变	zhengzhuang/nzygb/
脑白质变性	zhengzhuang/nbzbx/
脑白质偏少	zhengzhuang/nbzps/
脑白质脱髓鞘	zhengzhuang/nbztsq/
脑白质萎缩	zhengzhuang/nbzws/
脑白质稀疏	zhengzhuang/nbzxs/
脑穿通畸形	zhengzhuang/nctjx/
脑电波的改变	zhengzhuang/ndbdgb/
脑干病变	zhengzhuang/ngbb/
脑干出血	zhengzhuang/ngcx/
脑干梗塞	zhengzhuang/nggs/
脑干损害体征	zhengzhuang/ngshtz/
脑功能不全	zhengzhuang/ngnbq/
脑沟变宽	zhengzhuang/ngbk/
脑灰质移位	zhengzhuang/nhzyw/
脑灰质异常	zhengzhuang/nhzyc/
脑积水	zhengzhuang/njs/
脑脊髓膜浸润	zhengzhuang/njsmjr/
脑脊液白细胞增加	zhengzhuang/njybxbzj/
脑脊液鼻漏	zhengzhuang/njybl/
脑脊液蛋白量增高	zhengzhuang/njydblzg/
脑痉挛	zhengzhuang/njl/
脑膜刺激征	zhengzhuang/nmcjz/
脑膜刺激症状	zhengzhuang/nmcjzz/
脑膜炎	zhengzhuang/nmy/
脑膜增厚	zhengzhuang/nmzh/
脑脓肿	zhengzhuang/nnz/
脑器质性精神障碍	zhengzhuang/nqzxjsza/
脑桥小脑角综合征	zhengzhuang/nqxnjzhz/
脑缺血	zhengzhuang/nqx/
脑缺氧	zhengzhuang/nqy/
脑软化	zhengzhuang/nrh/
脑疝	zhengzhuang/ns/
脑疝危象	zhengzhuang/nswx/
脑神经麻痹	zhengzhuang/nsjmb/
脑实质出血	zhengzhuang/nszcx/
脑实质的浸润	zhengzhuang/nszdjr/
脑实质深部出血	zhengzhuang/nszsbcx/
脑室出血	zhengzhuang/nscx/
脑室受压移位	zhengzhuang/nssyyw/
脑衰弱综合征	zhengzhuang/nsrzhz/
脑水肿	zhengzhuang/nsz/
脑细胞出现营养不良性蜕变	zhengzhuang/nxbcxyyblxtb/
脑细胞脱水	zhengzhuang/nxbts/
脑血管动静脉畸形	zhengzhuang/nxgdjmjx/
脑血管痉挛	zhengzhuang/nxgjl/
脑炎样改变	zhengzhuang/nyygb/
脑叶出血	zhengzhuang/nycx/
脑占位性病变	zhengzhuang/nzwxbb/
脑转移	zhengzhuang/nzy/
讷吃	zhengzhuang/nc_2905/
能力减退感	zhengzhuang/nljtg/
能量不足	zhengzhuang/nlbz/
逆向型房室折返性心动过速	zhengzhuang/nxxfszfxxdgs/
逆行性细菌感染	zhengzhuang/nxxxjgr/
逆行性遗忘	zhengzhuang/nxxyw/
年轻女性心悸胸闷	zhengzhuang/nqnxxjxm/
年轻人的眼袋	zhengzhuang/nqrdyd/
黏稠或脓性痰伴有腥臭味	zhengzhuang/nchnxtbyxcw/
黏膜白斑	zhengzhuang/nmbb/
黏膜出现出血点	zhengzhuang/nmcxcxd/
黏膜干燥	zhengzhuang/nmgz/
黏膜稍苍白	zhengzhuang/nmscb/
黏膜损害	zhengzhuang/nmsh/
黏液便	zhengzhuang/nyb/
黏液分泌亢进	zhengzhuang/nyfmkj/
黏液囊肿	zhengzhuang/nynz/
黏液尿	zhengzhuang/nyn/
黏液脓性痰	zhengzhuang/nynxt/
黏液性水肿	zhengzhuang/nyxsz/
捻发音	zhengzhuang/nfy/
念珠菌感染	zhengzhuang/nzjgr/
鸟嘴样尖鼻	zhengzhuang/nzyjb/
尿暗黑色	zhengzhuang/nahs/
尿崩	zhengzhuang/nb/
尿比重下降	zhengzhuang/nbzxj/
尿比重增高	zhengzhuang/nbzzg/
尿闭	zhengzhuang/nb_2932/
尿常规异常	zhengzhuang/ncgyc/
尿赤	zhengzhuang/nc_2934/
尿胆红素阴性	zhengzhuang/ndhsyx/
尿胆原排泻增加	zhengzhuang/ndypxzj/
尿胆原增加	zhengzhuang/ndyzj/
尿蛋白	zhengzhuang/ndb/
尿道瓣	zhengzhuang/ndb_2939/
尿道变粗变硬	zhengzhuang/ndbcby/
尿道刺痒	zhengzhuang/ndcy/
尿道的条索状肿块	zhengzhuang/nddtszzk/
尿道分泌粘液或脓性分泌物	zhengzhuang/ndfmzyhnxfmw/
尿道结节	zhengzhuang/ndjj/
尿道结石	zhengzhuang/ndjs/
尿道局部肿胀	zhengzhuang/ndjbzz/
尿道口出现结节状或红色的出血性肿物	zhengzhuang/ndkcxjjzhhsdcxxzw/
尿道口疼	zhengzhuang/ndkt/
尿道口痒	zhengzhuang/ndky/
尿道口有白膜形成	zhengzhuang/ndkybmxc/
尿道口有红斑和水肿	zhengzhuang/ndkyhbhsz/
尿道口粘连	zhengzhuang/ndkzl/
尿道流出分泌物	zhengzhuang/ndlcfmw/
尿道流血	zhengzhuang/ndlx/
尿道瘘	zhengzhuang/ndl/
尿道弥漫性浸润	zhengzhuang/ndmmxjr/
尿道内虫咬感或阴道内虫爬感	zhengzhuang/ndncyghydncpg/
尿道内口呈漏斗样改变	zhengzhuang/ndnkcldygb/
尿道黏膜外翻	zhengzhuang/ndnmwf/
尿道烧灼感	zhengzhuang/ndszg/
尿道下裂	zhengzhuang/ndxl/
尿道痒感	zhengzhuang/ndyg/
尿淀粉酶升高	zhengzhuang/ndfmsg/
尿分叉	zhengzhuang/nfc/
尿钙增多	zhengzhuang/ngzd/
尿黑酸	zhengzhuang/nhs/
尿后滴沥	zhengzhuang/nhdl/
尿黄似浓茶	zhengzhuang/nhsnc/
尿急	zhengzhuang/nj/
尿磷	zhengzhuang/nl/
尿流变细或中断	zhengzhuang/nlbxhzd/
尿流缓慢	zhengzhuang/nlhm/
尿流中断	zhengzhuang/nlzd/
尿瘘	zhengzhuang/nl_2974/
尿滤过分数明显下降	zhengzhuang/nlgfsmxxj/
尿路结石	zhengzhuang/nljs/
尿锰粪锰	zhengzhuang/nmfm/
尿内出现蛋白及管型	zhengzhuang/nncxdbjgx/
尿钠排出量极低	zhengzhuang/nnpcljd/
尿偏碱	zhengzhuang/npj/
尿频	zhengzhuang/np/
尿频伴尿急和尿痛	zhengzhuang/npbnjhnt/
尿妊娠试验阳性	zhengzhuang/nrssyyx/
尿色酱红或呈酱油色	zhengzhuang/nsjhhcjys/
尿渗透压下降	zhengzhuang/nstyxj/
尿失禁	zhengzhuang/nsj/
尿失禁与遗尿	zhengzhuang/nsjyyn/
尿素廓清障碍	zhengzhuang/nskqza/
尿酸代谢亢进	zhengzhuang/nsdxkj/
尿酸化异常	zhengzhuang/nshyc/
尿酸结晶	zhengzhuang/nsjj/
尿酸盐在关节内沉积增多	zhengzhuang/nsyzgjncjzd/
尿糖	zhengzhuang/nt/
尿痛	zhengzhuang/nt_2994/
尿外渗	zhengzhuang/nws/
尿血	zhengzhuang/nx/
尿液氨水味	zhengzhuang/nyasw/
尿液呈黑色	zhengzhuang/nychs/
尿液臭味	zhengzhuang/nycw/
尿液混浊	zhengzhuang/nyhz/
尿液烂苹果味	zhengzhuang/nylpgw/
尿液中有稠厚胶样物	zhengzhuang/nyzychjyw/
尿意窘迫	zhengzhuang/nyjp/
尿隐血	zhengzhuang/nyx/
尿中持续性排钠	zhengzhuang/nzcxxpn/
尿中雌激素增高	zhengzhuang/nzcjszg/
尿中磷酸盐排出增多	zhengzhuang/nzlsypczd/
尿中有较多尿卟啉	zhengzhuang/nzyjdnbl/
尿中有特殊鼠臭味	zhengzhuang/nzytsscw/
尿中组织胺排泄增加	zhengzhuang/nzzzapxzj/
颞部疼痛	zhengzhuang/nbtt/
颞骨隆起	zhengzhuang/nglq/
柠檬色痰	zhengzhuang/nmst/
凝肩	zhengzhuang/nj_3014/
凝视麻痹	zhengzhuang/nsmb/
凝视征	zhengzhuang/nsz_3016/
凝血功能障碍	zhengzhuang/nxgnza/
凝血因子功能的障碍	zhengzhuang/nxyzgndza/
凝血障碍	zhengzhuang/nxza/
牛奶色或米汤样便	zhengzhuang/nnshmtyb/
扭伤	zhengzhuang/ns_3021/
扭转动作	zhengzhuang/nzdz/
扭转痉挛	zhengzhuang/nzjl/
脓包	zhengzhuang/nb_3024/
脓包型痘痘	zhengzhuang/nbxdd/
脓鼻涕增多且不易擤尽	zhengzhuang/nbtzdqbyxj/
脓毒性血栓	zhengzhuang/ndxxs/
脓毒性血症或多发性迁徙性脓肿	zhengzhuang/ndxxzhdfxqxxnz/
脓痱	zhengzhuang/nf/
脓尿	zhengzhuang/nn/
脓疱	zhengzhuang/np_3031/
脓疱性痤疮	zhengzhuang/npxcc/
脓苔	zhengzhuang/nt_3033/
脓痰	zhengzhuang/nt_3034/
脓性分泌物	zhengzhuang/nxfmw/
脓性分泌物增多	zhengzhuang/nxfmwzd/
脓胸	zhengzhuang/nx_3037/
脓血性白带	zhengzhuang/nxxbd/
脓液为巧克力色或查到阿米巴原虫	zhengzhuang/nywqklshcdambyc/
脓肿	zhengzhuang/nz_3040/
脓肿破入胸腔	zhengzhuang/nzprxq/
努嘴伸舌	zhengzhuang/nzss/
女性膀胱颈梗阻	zhengzhuang/nxbgjgz/
女性不孕	zhengzhuang/nxby_3044/
女性第二性征消失	zhengzhuang/nxdexzxs/
女性乳房表浅质硬状如象皮者的皮下结节	zhengzhuang/nxrfbqzyzrxpzdpxjj/
女性体毛多	zhengzhuang/nxtmd/
女性小腹疼痛	zhengzhuang/nxxftt/
女性型肥胖	zhengzhuang/nxxfp_3049/
女性性器官反应缺乏	zhengzhuang/nxxqgfyqf/
女性性早熟	zhengzhuang/nxxzs_3051/
女性腰骶生理性前突明显	zhengzhuang/nxydslxqtmx/
女性周期性鼻塞和鼻衄	zhengzhuang/nxzqxbshbn/
女阴会阴出现红色结痂斑块	zhengzhuang/nyhycxhsjjbk/
皮肤粘连	zhengzhuang/pfzl/
桡骨头发育不良	zhengzhuang/rgtfybl/
粘膜充血	zhengzhuang/zmcx/
粘膜乳突状生长	zhengzhuang/zmrtzsc/
粘膜萎缩	zhengzhuang/zmws/
粘膜有粘着性白斑	zhengzhuang/zmyzzxbb/
粘膜增生性炎症	zhengzhuang/zmzsxyz/
粘膜疹	zhengzhuang/zmz/
粘性渗出性薄膜	zhengzhuang/zxscxbm/
粘液腺体肥大	zhengzhuang/zyxtfd/
粘液性水肿面容	zhengzhuang/zyxszmr/
PAS染色阳性	zhengzhuang/pasrsyx/
膀胱残余尿量增多	zhengzhuang/bgcynlzd/
膀胱刺激征	zhengzhuang/bgcjz/
膀胱功能障碍	zhengzhuang/bggnza/
膀胱结核	zhengzhuang/bgjh/
膀胱痉挛	zhengzhuang/bgjl/
膀胱排空不全	zhengzhuang/bgpkbq/
膀胱膨隆	zhengzhuang/bgpl/
膀胱憩室	zhengzhuang/bgqs/
膀胱容量的减少	zhengzhuang/bgrldjs/
膀胱纤维化	zhengzhuang/bgxwh/
膀胱阴道瘘	zhengzhuang/bgydl/
腓肠肌痉挛	zhengzhuang/fcjjl/
腓肠肌痉挛性疼痛	zhengzhuang/fcjjlxtt/
腓肠肌拉伤	zhengzhuang/fcjls/
腓肠肌强直收缩并有疼痛	zhengzhuang/fcjqzssbytt/
腓肠肌撕裂	zhengzhuang/fcjsl/
腓肠肌压痛	zhengzhuang/fcjyt/
腓骨肌对称萎缩逐渐向上发展	zhengzhuang/fgjdcwszjxsfz/
帕里诺眼-腺综合征	zhengzhuang/plny_xzhz/
排便不尽感	zhengzhuang/pbbjg/
排便感	zhengzhuang/pbg/
排便困难	zhengzhuang/pbkn/
排便频率异常	zhengzhuang/pbplyc/
排便时间过长	zhengzhuang/pbsjgc/
排便障碍	zhengzhuang/pbza/
排出结石	zhengzhuang/pcjs/
排粪时肛门灼痛	zhengzhuang/pfsgmzt/
排钾过多	zhengzhuang/pjgd/
排尿不畅	zhengzhuang/pnbc/
排尿过程中发生晕厥	zhengzhuang/pngczfsyj/
排尿困难及尿潴留	zhengzhuang/pnknjnzl/
排尿前后膀胱区痛	zhengzhuang/pnqhbgqt/
排尿时外阴灼热、瘙痒或疼痛	zhengzhuang/pnswyzr_syhtt/
排尿疼痛	zhengzhuang/pntt/
排尿异物感	zhengzhuang/pnywg/
排尿障碍	zhengzhuang/pnza/
排气多	zhengzhuang/pqd/
排气障碍	zhengzhuang/pqza/
排水样血性大便	zhengzhuang/psyxxdb/
排痰无力	zhengzhuang/ptwl/
盘状红斑	zhengzhuang/pzhb/
蹒跚步态	zhengzhuang/psbt/
判断力和定向力障碍	zhengzhuang/pdlhdxlza/
泡样水肿	zhengzhuang/pysz/
疱疹	zhengzhuang/pz/
疱疹后神经痛	zhengzhuang/pzhsjt/
胚胎发育供血不足	zhengzhuang/ptfygxbz/
胚胎发育慢	zhengzhuang/ptfym/
胚胎发育障碍	zhengzhuang/ptfyza/
胚胎停止发育	zhengzhuang/pttzfy/
赔偿神经症	zhengzhuang/pcsjz/
盆腔包块	zhengzhuang/pqbk/
盆腔沉重感	zhengzhuang/pqczg/
盆腔积液	zhengzhuang/pqjy/
盆腔脊膜膨出	zhengzhuang/pqjmpc/
盆腔内有较广泛浸润	zhengzhuang/pqnyjgfjr/
盆腔脓肿	zhengzhuang/pqnz/
盆腔下垂感	zhengzhuang/pqxcg/
盆腔瘀血	zhengzhuang/pqyx/
盆腔肿块	zhengzhuang/pqzk/
盆腔坠痛	zhengzhuang/pqzt/
膨胀性肝脏搏动	zhengzhuang/pzxgzbd/
膨胀性萎缩纹	zhengzhuang/pzxwsw/
碰撞后皮肤容易青紫	zhengzhuang/pzhpfryqz/
皮窦道	zhengzhuang/pdd/
皮肤白喉	zhengzhuang/pfbh/
皮肤绷紧肥厚失去弹性	zhengzhuang/pfbjfhsqdx/
皮肤边缘翘起	zhengzhuang/pfbyqq/
皮肤变薄、发亮	zhengzhuang/pfbb_fl/
皮肤表面常出现大小不一散在性血泡	zhengzhuang/pfbmccxdxbyszxxp/
皮肤擦伤	zhengzhuang/pfcs/
皮肤苍白	zhengzhuang/pfcb/
皮肤呈黄绿或绿褐色	zhengzhuang/pfchlhlhs/
皮肤呈鳞片状	zhengzhuang/pfclpz/
皮肤呈浅黄或深金黄色	zhengzhuang/pfcqhhsjhs/
皮肤呈实质性非凹陷性发硬	zhengzhuang/pfcszxfaxxfy/
皮肤出现硬块	zhengzhuang/pfcxyk/
皮肤出血斑	zhengzhuang/pfcxb/
皮肤出血点	zhengzhuang/pfcxd/
皮肤触痛	zhengzhuang/pfct/
粪类圆线虫病	zhengzhuang/flyxcb/
皮肤粗糙	zhengzhuang/pfcc/
皮肤脆性增加	zhengzhuang/pfcxzj/
皮肤皴裂	zhengzhuang/pfcl/
皮肤弹性差	zhengzhuang/pfdxc/
皮肤的非干酪性肉芽肿	zhengzhuang/pfdfglxryz/
皮肤冻伤	zhengzhuang/pfds/
皮肤多痣	zhengzhuang/pfdz/
皮肤发黑瘙痒	zhengzhuang/pffhsy/
皮肤发红	zhengzhuang/pffh/
皮肤发黄	zhengzhuang/pffh_3157/
皮肤发黄但巩膜没有黄染	zhengzhuang/pffhdgmmyhr/
皮肤肥厚	zhengzhuang/pffh_3159/
皮肤丰满度丧失	zhengzhuang/pffmdss/
皮肤钙沉着	zhengzhuang/pfgcz/
皮肤钙化	zhengzhuang/pfgh/
皮肤干而发红	zhengzhuang/pfgefh/
皮肤干燥	zhengzhuang/pfgz/
皮肤干燥呈腊黄色	zhengzhuang/pfgzclhs/
皮肤龟裂	zhengzhuang/pfgl/
皮肤过度伸展	zhengzhuang/pfgdsz/
皮肤过敏	zhengzhuang/pfgm/
皮肤含铁血黄素沉着	zhengzhuang/pfhtxhscz/
皮肤和软组织感染	zhengzhuang/pfhrzzgr/
皮肤黑斑	zhengzhuang/pfhb/
皮肤黑变	zhengzhuang/pfhb_3172/
皮肤花斑样	zhengzhuang/pfhby/
皮肤花纹	zhengzhuang/pfhw/
皮肤划线处的风团样损害	zhengzhuang/pfhxcdftysh/
皮肤坏死	zhengzhuang/pfhs/
皮肤或粘膜上附着高锰酸钾结晶	zhengzhuang/pfhzmsfzgmsjjj/
皮肤肌肉增厚、纤维化	zhengzhuang/pfjrzh_xwh/
皮肤疖痈	zhengzhuang/pfjy/
皮肤浸润	zhengzhuang/pfjr/
皮肤皲裂	zhengzhuang/pfjl/
皮肤老化	zhengzhuang/pflh/
皮肤冷而苍白粘腻	zhengzhuang/pflecbzn/
皮肤落屑并导致表皮剥脱	zhengzhuang/pflxbdzbpbt/
皮肤弥漫性红肿	zhengzhuang/pfmmxhz/
皮肤黏蛋白沉积	zhengzhuang/pfndbcj/
皮肤黏膜苍白	zhengzhuang/pfnmcb/
皮肤黏膜出血	zhengzhuang/pfnmcx/
皮肤黏膜紫斑	zhengzhuang/pfnmzb/
皮肤青紫色改变	zhengzhuang/pfqzsgb/
皮肤轻度糜烂	zhengzhuang/pfqdml/
皮肤轻微创伤即可产生鱼嘴样裂隙	zhengzhuang/pfqwcsjkcsyzylx/
皮肤肉芽肿	zhengzhuang/pfryz/
皮肤软组织感染	zhengzhuang/pfrzzgr/
皮肤搔痒	zhengzhuang/pfsy/
皮肤瘙痒	zhengzhuang/pfsy_3196/
皮肤色素沉着呈青铜色	zhengzhuang/pfssczcqts/
皮肤色素加深	zhengzhuang/pfssjs/
皮肤闪电疼痛	zhengzhuang/pfsdtt/
皮肤上线状排列的小水疱伴发疼痛	zhengzhuang/pfsxzpldxspbftt/
皮肤湿毒	zhengzhuang/pfsd/
皮肤湿冷	zhengzhuang/pfsl/
皮肤受累	zhengzhuang/pfsl_3203/
皮肤水疱，后形成黑色干痂	zhengzhuang/pfsp_hxchsgj/
皮肤撕脱伤	zhengzhuang/pfsts/
皮肤松弛起皱	zhengzhuang/pfscqz/
皮肤胎痣	zhengzhuang/pftz/
皮肤痛	zhengzhuang/pft/
皮肤为金属颜色或石板灰色	zhengzhuang/pfwjsyshsbhs/
皮肤萎缩和色素沉着	zhengzhuang/pfwshsscz/
皮肤温度升高	zhengzhuang/pfwdsg/
皮肤无光泽	zhengzhuang/pfwgz/
皮肤型屈肢症	zhengzhuang/pfxqzz/
皮肤血管收缩呈网状图案	zhengzhuang/pfxgsscwzta/
皮肤异色症	zhengzhuang/pfysz/
皮肤硬化	zhengzhuang/pfyh/
皮肤硬结冷时疼痛热时瘙痒	zhengzhuang/pfyjlsttrssy/
皮肤油腻	zhengzhuang/pfyn/
皮肤油脂过多	zhengzhuang/pfyzgd/
皮肤有瘙痒抓痕	zhengzhuang/pfysyzh/
皮肤有压痕	zhengzhuang/pfyyh/
皮肤瘀斑	zhengzhuang/pfyb/
皮肤瘀点	zhengzhuang/pfyd/
皮肤粘膜红紫	zhengzhuang/pfzmhz/
皮肤粘膜色素斑	zhengzhuang/pfzmssb/
皮肤张力增加	zhengzhuang/pfzlzj/
皮肤痣	zhengzhuang/pfz/
皮肤逐渐呈暗黑色	zhengzhuang/pfzjcahs/
皮肤转移	zhengzhuang/pfzy/
皮肤紫癜	zhengzhuang/pfzd/
皮肤紫纹	zhengzhuang/pfzw/
皮肌炎Gottron征	zhengzhuang/pjygottronz/
藏毛窦	zhengzhuang/cmd/
皮面上针头大小瘙痒点	zhengzhuang/pmsztdxsyd/
皮损可呈角样突起	zhengzhuang/pskcjytq/
皮损皮黄到橙色	zhengzhuang/psphdcs/
皮损似干燥的灰泥样	zhengzhuang/pssgzdhny/
皮温降低	zhengzhuang/pwjd/
皮下沉积所出现的粟粒样结节	zhengzhuang/pxcjscxdslyjj/
皮下结节	zhengzhuang/pxjj/
皮下静脉呈网状怒张	zhengzhuang/pxjmcwznz/
皮下囊肿	zhengzhuang/pxnz/
皮下气肿	zhengzhuang/pxqz/
皮下深部筋膜进行性坏死性感染	zhengzhuang/pxsbjmjxxhsxgr/
皮下血肿	zhengzhuang/pxxz/
皮下脂肪坏死	zhengzhuang/pxzfhs/
皮下脂肪粒	zhengzhuang/pxzfl/
皮下脂肪萎缩	zhengzhuang/pxzfws/
皮下脂肪消失	zhengzhuang/pxzfxs/
皮下脂肪增多	zhengzhuang/pxzfzd/
皮下指头至鸽蛋大的肿块结节	zhengzhuang/pxztzgdddzkjj/
皮下组织水肿	zhengzhuang/pxzzsz/
皮下组织硬结	zhengzhuang/pxzzyj/
皮炎	zhengzhuang/py/
皮疹呈瘀点	zhengzhuang/pzcyd/
皮质醇增多	zhengzhuang/pzczd/
皮质功能减退	zhengzhuang/pzgnjt/
皮质激素升高	zhengzhuang/pzjssg/
皮质激素依赖	zhengzhuang/pzjsyl/
皮质胶质增生	zhengzhuang/pzjzzs/
皮质滤泡萎缩	zhengzhuang/pzlpws/
皮质素不足	zhengzhuang/pzsbz/
皮质下痴呆	zhengzhuang/pzxcd/
皮质性遗忘症	zhengzhuang/pzxywz/
疲乏	zhengzhuang/pf/
疲劳	zhengzhuang/pl/
啤酒肚	zhengzhuang/pjd/
脾大	zhengzhuang/pd/
脾功能亢进	zhengzhuang/pgnkj/
脾气虚	zhengzhuang/pqx/
脾肾阳虚	zhengzhuang/psyx/
脾湿	zhengzhuang/ps/
脾栓塞	zhengzhuang/pss/
脾萎缩	zhengzhuang/pws/
脾胃不和	zhengzhuang/pwbh/
脾胃湿热	zhengzhuang/pwsr/
脾胃虚寒	zhengzhuang/pwxh/
脾胃虚弱	zhengzhuang/pwxr/
脾虚	zhengzhuang/px/
脾阳虚	zhengzhuang/pyx/
脾肿大	zhengzhuang/pzd/
脾紫癜	zhengzhuang/pzd_3282/
偏侧空间忽略症	zhengzhuang/pckjhlz/
偏盲	zhengzhuang/pm/
偏盲偏身感觉障碍	zhengzhuang/pmpsgjza/
偏身肌张力障碍	zhengzhuang/psjzlza/
偏身麻木	zhengzhuang/psmm/
偏身萎缩	zhengzhuang/psws/
偏瘫	zhengzhuang/pt/
偏头痛	zhengzhuang/ptt/
偏斜骨盆	zhengzhuang/pxgp/
偏执型人格障碍	zhengzhuang/pzxrgza/
偏执性妄想	zhengzhuang/pzxwx/
偏执状态	zhengzhuang/pzzt/
胼胝体发育不良	zhengzhuang/pztfybl/
贫血	zhengzhuang/px_3296/
贫血貌	zhengzhuang/pxm/
频发房性早搏	zhengzhuang/pffxzb/
频发室性期前收缩	zhengzhuang/pfsxqqss/
频繁发笑	zhengzhuang/pffx/
频繁呕吐及便秘	zhengzhuang/pfotjbm/
频繁吐黏液	zhengzhuang/pftny/
频繁性惊醒	zhengzhuang/pfxjx/
频繁遗精	zhengzhuang/pfyj/
频吐白沫	zhengzhuang/ptbm/
品行障碍	zhengzhuang/pxza/
平衡功能障碍	zhengzhuang/phgnza/
平滑肌痉挛	zhengzhuang/phjjl/
平卧呼吸困难	zhengzhuang/pwhxkn/
迫害妄想	zhengzhuang/phwx/
扑翼样震颤	zhengzhuang/pyyzc/
铺路石样变性	zhengzhuang/plsybx/
葡萄膜炎	zhengzhuang/ptmy/
普秃	zhengzhuang/pt_3314/
蹼状瘢痕	zhengzhuang/pzbh/
QRS波宽大畸形	zhengzhuang/qrsbkdjx/
Q-T间期延长	zhengzhuang/q_tjqyc/
Q角异常	zhengzhuang/qjyc/
期外收缩	zhengzhuang/qwss/
漆裂样纹	zhengzhuang/qlyw/
奇脉	zhengzhuang/qm/
脐残端有少量黏液或脓性分泌物	zhengzhuang/qcdyslnyhnxfmw/
脐疮	zhengzhuang/qc/
脐带感染	zhengzhuang/qdgr/
脐带过短	zhengzhuang/qdgd/
脐带绕颈	zhengzhuang/qdrj/
脐轮红肿	zhengzhuang/qlhz/
脐湿	zhengzhuang/qs/
脐突	zhengzhuang/qt/
脐窝内有肉芽组织增生	zhengzhuang/qwnyryzzzs/
脐窝内有樱红色息肉样物	zhengzhuang/qwnyyhsxryw/
脐血	zhengzhuang/qx/
脐周明显红肿变硬	zhengzhuang/qzmxhzby/
脐周脓性分泌物较多	zhengzhuang/qznxfmwjd/
脐周疼痛	zhengzhuang/qztt/
脐周阵发性绞痛	zhengzhuang/qzzfxjt/
起搏频率增高	zhengzhuang/qbplzg/
气不摄血	zhengzhuang/qbsx/
气喘	zhengzhuang/qc_3339/
气道变窄	zhengzhuang/qdbz/
气道高反应性	zhengzhuang/qdgfyx/
气道和食管之间的瘘管	zhengzhuang/qdhsgzjdlg/
气道陷闭	zhengzhuang/qdxb/
气短	zhengzhuang/qd/
气腹征	zhengzhuang/qfz/
气管处可听到异物冲击的拍击声	zhengzhuang/qgcktdywcjdpjs/
气管和纵隔移位	zhengzhuang/qghzgyw/
气管间隙形成肿块	zhengzhuang/qgjxxczk/
气管隆突以上的损伤	zhengzhuang/qgltysdss/
中度吸入性损伤	zhengzhuang/zdxrxss/
气管受压	zhengzhuang/qgsy/
气管移位	zhengzhuang/qgyw/
气管纵隔和心脏向健侧移位	zhengzhuang/qgzghxzxjcyw/
气管阻塞	zhengzhuang/qgzs/
气过水声	zhengzhuang/qgss/
气机不畅	zhengzhuang/qjbc/
气机失调	zhengzhuang/qjsd/
气急	zhengzhuang/qj/
气上沖心	zhengzhuang/qscx/
气体弥散功能下降	zhengzhuang/qtmsgnxj/
气体弥散障碍	zhengzhuang/qtmsza/
气息异常	zhengzhuang/qxyc/
气胸	zhengzhuang/qx_3363/
气虚体质	zhengzhuang/qxtz/
气血凝滞	zhengzhuang/qxnz/
气血失和	zhengzhuang/qxsh/
气血虚弱	zhengzhuang/qxxr/
气压伤	zhengzhuang/qys/
气郁体质	zhengzhuang/qytz/
气滞血瘀	zhengzhuang/qzxy/
器质性精神障碍	zhengzhuang/qzxjsza/
器质性木僵	zhengzhuang/qzxmj/
器质性弱视	zhengzhuang/qzxrs/
器质性神经损害	zhengzhuang/qzxsjsh/
器质性早泄	zhengzhuang/qzxzx/
憩室出血	zhengzhuang/qscx_3376/
髂骨角增大	zhengzhuang/qgjzd/
髂窝部疼痛	zhengzhuang/qwbtt/
迁徙性浅静脉血栓形成	zhengzhuang/qxxqjmxsxc/
迁移性脓肿	zhengzhuang/qyxnz/
牵涉痛	zhengzhuang/qst/
牵涉性头痛	zhengzhuang/qsxtt/
牵引性头痛	zhengzhuang/qyxtt/
铅管样强直	zhengzhuang/qgyqz/
前臂短缩	zhengzhuang/qbds/
前臂和腕部的疼痛	zhengzhuang/qbhwbdtt/
前臂及手部肌群的缺血性挛缩	zhengzhuang/qbjsbjqdqxxls/
前臂外侧和手指触电样疼痛	zhengzhuang/qbwchszcdytt/
前臂外伤后疼痛	zhengzhuang/qbwshtt/
前臂细小	zhengzhuang/qbxx/
前臂旋后功能受限	zhengzhuang/qbxhgnsx/
前臂旋转痛	zhengzhuang/qbxzt/
前臂有旋前畸形	zhengzhuang/qbyxqjx/
前额及颧骨突出	zhengzhuang/qejqgtc/
前额头痛	zhengzhuang/qett/
前额针刺样痛或烧灼感	zhengzhuang/qezcythszg/
前房色素沉积	zhengzhuang/qfsscj/
前房下方有红色血平面	zhengzhuang/qfxfyhsxpm/
前房中肿胀的晶状体皮质颗粒	zhengzhuang/qfzzzdjztpzkl/
前列腺肥大	zhengzhuang/qlxfd/
前列腺分泌物含有许多脓缩细胞	zhengzhuang/qlxfmwhyxdnsxb/
前列腺钙化	zhengzhuang/qlxgh/
前列腺结石	zhengzhuang/qlxjs/
前列腺素合成减少	zhengzhuang/qlxshcjs/
前列腺缩小变硬	zhengzhuang/qlxsxby/
前列腺硬结	zhengzhuang/qlxyj/
前列腺增生	zhengzhuang/qlxzs/
前期妊娠反应	zhengzhuang/qqrsfy/
前庭反射消失	zhengzhuang/qtfsxs/
前庭神经受损	zhengzhuang/qtsjss/
前庭性共济失调	zhengzhuang/qtxgjsd/
前斜角肌肥厚痉挛	zhengzhuang/qxjjfhjl/
前囟饱满	zhengzhuang/qxbm/
前囟闭合延迟	zhengzhuang/qxbhyc/
前囟张力增高	zhengzhuang/qxzlzg/
潜在中毒	zhengzhuang/qzzd/
浅表淋巴结进行性肿大	zhengzhuang/qblbjjxxzd/
浅表淋巴结肿大	zhengzhuang/qblbjzd/
浅表性疤痕	zhengzhuang/qbxbh/
浅感觉减退或缺失	zhengzhuang/qgjjthqs/
浅昏迷	zhengzhuang/qhm/
浅筋膜炎	zhengzhuang/qjmy/
浅静脉有一发红低热的索状物	zhengzhuang/qjmyyfhdrdszw/
浅眠	zhengzhuang/qm_3424/
浅棕色斑点	zhengzhuang/qzsbd/
呛咳	zhengzhuang/qk/
强迫侧卧位	zhengzhuang/qpcww/
强迫蹲位	zhengzhuang/qpdw/
强迫俯卧位	zhengzhuang/qpfww/
强迫观念	zhengzhuang/qpgn/
强迫恐怖症	zhengzhuang/qpkbz/
强迫停立位	zhengzhuang/qptlw/
强迫行为	zhengzhuang/qpxw/
强迫型人格障碍	zhengzhuang/qpxrgza/
强直性脊柱炎	zhengzhuang/qzxjzy/
强迫性联想	zhengzhuang/qpxlx/
强迫性穷思竭虑	zhengzhuang/qpxqsjl/
强迫性人格	zhengzhuang/qpxrg/
强迫性神经官能症	zhengzhuang/qpxsjgnz/
强迫性体位	zhengzhuang/qpxtw/
强迫性头颈倾斜畸形	zhengzhuang/qpxtjqxjx/
强迫性头位	zhengzhuang/qpxtw_3442/
强迫性性行为	zhengzhuang/qpxxxw/
强迫性重复	zhengzhuang/qpxzf/
强迫仰卧位	zhengzhuang/qpyww/
强迫症	zhengzhuang/qpz/
强握反射	zhengzhuang/qwfs/
强笑	zhengzhuang/qx_3448/
强硬舌	zhengzhuang/qys_3449/
强直性肌张力增高	zhengzhuang/qzxjzlzg/
强制性哭笑	zhengzhuang/qzxkx/
强制性思维	zhengzhuang/qzxsw/
蔷薇疹样皮疹	zhengzhuang/qwzypz/
桥脑出血	zhengzhuang/qncx/
桥脑梗塞	zhengzhuang/qngs/
鞘膜积水	zhengzhuang/qmjs/
侵蚀性骨破坏	zhengzhuang/qsxgph/
侵蚀性水疱	zhengzhuang/qsxsp/
青春期肥胖	zhengzhuang/qcqfp/
青春期功血	zhengzhuang/qcqgx/
青春期后无精液	zhengzhuang/qcqhwjy/
青春期甲亢	zhengzhuang/qcqjk/
青春期身体发育缓慢	zhengzhuang/qcqstfyhm/
青春期胸部发育缓慢	zhengzhuang/qcqxbfyhm/
青春前期闭经	zhengzhuang/qcqqbj/
青春危险期	zhengzhuang/qcwxq/
青光眼斑	zhengzhuang/qgyb/
青红肤色	zhengzhuang/qhfs/
青红丘疹	zhengzhuang/qhqz/
青年白内障	zhengzhuang/qnbnz/
青少年白发	zhengzhuang/qsnbf/
青少年脊柱侧凸	zhengzhuang/qsnjzct/
青少年膝痛	zhengzhuang/qsnxt/
青枝骨折	zhengzhuang/qzgz/
青紫舌	zhengzhuang/qzs/
轻度精神发育迟滞	zhengzhuang/qdjsfycz/
轻度烧伤	zhengzhuang/qdss/
轻度痛	zhengzhuang/qdt/
轻度中毒	zhengzhuang/qdzd/
轻瘫	zhengzhuang/qt_3480/
轻压指甲，指头微红状不能马上恢复	zhengzhuang/qyzj_ztwhzbnmshf/
倾倒综合征	zhengzhuang/qdzhz/
清晨或上午头痛	zhengzhuang/qchswtt/
清晨早醒且不能再度入睡	zhengzhuang/qczxqbnzdrs/
情感暴发	zhengzhuang/qgbf/
情感淡漠	zhengzhuang/qgdm/
情感倒错	zhengzhuang/qgdc/
情感高涨	zhengzhuang/qggz/
情感麻痹	zhengzhuang/qgmb/
情感依赖	zhengzhuang/qgyl/
情景性晕厥	zhengzhuang/qjxyj/
情绪低落	zhengzhuang/qxdl/
情绪起伏大	zhengzhuang/qxqfd/
情绪性癌症	zhengzhuang/qxxaz/
情绪性多汗症	zhengzhuang/qxxdhz/
情绪性腹痛	zhengzhuang/qxxft/
情绪性感冒	zhengzhuang/qxxgm/
情绪性高血压	zhengzhuang/qxxgxy/
情绪性进食	zhengzhuang/qxxjs/
情绪性疲劳	zhengzhuang/qxxpl/
情绪性失眠	zhengzhuang/qxxsm/
情绪性头痛	zhengzhuang/qxxtt/
情绪性胃痛	zhengzhuang/qxxwt/
情绪性哮喘	zhengzhuang/qxxxc/
情绪性厌食	zhengzhuang/qxxys/
情志内伤	zhengzhuang/qzns/
氰化物烧伤及合并中毒	zhengzhuang/qhwssjhbzd/
丘脑出血	zhengzhuang/qncx_3508/
丘脑下部损害	zhengzhuang/qnxbsh/
丘疹	zhengzhuang/qz/
丘疹性痤疮	zhengzhuang/qzxcc/
秋季狂躁症	zhengzhuang/qjkzz/
球蛋白异常	zhengzhuang/qdbyc/
球后溃疡	zhengzhuang/qhky/
球后视神经炎	zhengzhuang/qhssjy/
曲棍球棒手	zhengzhuang/qgqbs/
屈光不正性弱视	zhengzhuang/qgbzxrs/
屈光参差性弱视	zhengzhuang/qgccxrs/
屈光介质混浊	zhengzhuang/qgjzhz/
屈髋屈膝及外旋畸形	zhengzhuang/qkqxjwxjx/
屈曲指	zhengzhuang/qqz/
屈伸不利	zhengzhuang/qsbl/
屈腕屈指无力	zhengzhuang/qwqzwl/
屈性截瘫	zhengzhuang/qxjt/
躯干畸形弯曲	zhengzhuang/qgjxwq/
躯体化障碍	zhengzhuang/qthza/
躯体或颜面某一局部的连续性抽动	zhengzhuang/qthymmyjbdlxxcd/
躯体形式疼痛障碍	zhengzhuang/qtxsttza/
躯体性疾病所致的精神障碍	zhengzhuang/qtxjbszdjsza/
躯体依赖性	zhengzhuang/qtylx/
躯体主诉增多	zhengzhuang/qtzszd/
去大脑强直	zhengzhuang/qdnqz/
去首高血压	zhengzhuang/qsgxy/
去质状态	zhengzhuang/qzzt/
全腹痛	zhengzhuang/qft/
全身持续性水肿	zhengzhuang/qscxxsz/
全身代谢低下	zhengzhuang/qsdxdx/
全身感染中毒症状	zhengzhuang/qsgrzdzz/
全身各脏器血流缓慢	zhengzhuang/qsgzqxlhm/
全身骨骼肌痉挛	zhengzhuang/qsggjjl/
全身骨骼肌收缩	zhengzhuang/qsggjss/
全身过敏反应	zhengzhuang/qsgmfy/
全身过敏和发热皮疹关节痛	zhengzhuang/qsgmhfrpzgjt/
全身肌张力障碍	zhengzhuang/qsjzlza/
全身紧束感	zhengzhuang/qsjsg/
全身毛发呈灰白色	zhengzhuang/qsmfchbs/
全身弥漫性潮红	zhengzhuang/qsmmxch/
全身皮肤充血	zhengzhuang/qspfcx/
全身皮肤粗厚	zhengzhuang/qspfch/
全身皮肤及粘膜呈现不同程度青紫色	zhengzhuang/qspfjzmcxbtcdqzs/
全身皮肤散在黑痣	zhengzhuang/qspfszhz/
全身衰竭	zhengzhuang/qssj/
全身消瘦型	zhengzhuang/qsxsx/
全身性血管损害	zhengzhuang/qsxxgsh/
全秃	zhengzhuang/qt_3555/
全血细胞减少	zhengzhuang/qxxbjs/
拳状手畸形	zhengzhuang/qzsjx/
醛固酮分泌增多	zhengzhuang/qgtfmzd/
颧红盗汗	zhengzhuang/qhdh/
颧面部塌陷	zhengzhuang/qmbtx/
犬吠样咳嗽	zhengzhuang/qfyks/
缺碘	zhengzhuang/qd_3562/
缺乏深睡眠	zhengzhuang/qfssm/
缺乏性的兴趣和性活动的要求	zhengzhuang/qfxdxqhxhddyq/
缺乏自控能力	zhengzhuang/qfzknl/
缺铁性贫血	zhengzhuang/qtxpx/
缺血性挛缩	zhengzhuang/qxxls/
缺氧缺血性神经损伤	zhengzhuang/qyqxxsjss/
缺智齿	zhengzhuang/qzc/
雀斑	zhengzhuang/qb/
栓状齿	zhengzhuang/szc/
纤维膜包裹	zhengzhuang/xwmbg/
小儿前囟凹陷	zhengzhuang/xeqxax/
颧骨额骨下陷	zhengzhuang/qgegxx/
染色体畸形	zhengzhuang/rstjx/
桡骨茎突部局限性疼痛	zhengzhuang/rgjtbjxxtt/
桡骨茎突剧痛	zhengzhuang/rgjtjt/
热痱	zhengzhuang/rf/
热结节	zhengzhuang/rjj/
热痉挛	zhengzhuang/rjl/
热衰竭	zhengzhuang/rsj/
热痰口臭	zhengzhuang/rtkc/
热痛	zhengzhuang/rt/
人格改变	zhengzhuang/rggb/
人格解体	zhengzhuang/rgjt/
人工流产术后出血	zhengzhuang/rglcshcx/
人中圆凸	zhengzhuang/rzyt/
认识能力缺失	zhengzhuang/rsnlqs/
认知功能损害	zhengzhuang/rzgnsh/
认知功能障碍	zhengzhuang/rzgnza/
认知神经功能丧失	zhengzhuang/rzsjgnss/
妊高征	zhengzhuang/rgz/
妊娠斑	zhengzhuang/rsb/
妊娠蛋白尿	zhengzhuang/rsdbn/
妊娠毒血症	zhengzhuang/rsdxz/
妊娠反应	zhengzhuang/rsfy/
妊娠高血压征	zhengzhuang/rsgxyz/
妊娠后期水肿	zhengzhuang/rshqsz/
妊娠期的生理变化	zhengzhuang/rsqdslbh/
妊娠期高血压	zhengzhuang/rsqgxy/
妊娠期急性脂肪肝	zhengzhuang/rsqjxzfg/
妊娠期间甲亢	zhengzhuang/rsqjjk/
妊娠期间小便不通	zhengzhuang/rsqjxbbt/
妊娠期胸痛	zhengzhuang/rsqxt/
妊娠期血糖高	zhengzhuang/rsqxtg/
妊娠时伴有腹痛的阴道流血	zhengzhuang/rssbyftdydlx/
妊娠时持续性腹痛或腰酸腰痛	zhengzhuang/rsscxxfthysyt/
妊娠时出现的多毛	zhengzhuang/rsscxddm/
妊娠时皮肤皱褶处小脓疱	zhengzhuang/rsspfzzcxnp/
妊娠晚期或临产时无痛性反复阴道流血	zhengzhuang/rswqhlcswtxffydlx/
妊娠性黄褐斑	zhengzhuang/rsxhhb/
妊娠痒疹	zhengzhuang/rsyz/
妊娠中毒	zhengzhuang/rszd/
韧带断裂	zhengzhuang/rddl/
韧带骨化	zhengzhuang/rdgh/
韧带拉伤	zhengzhuang/rdls/
韧带扭伤	zhengzhuang/rdns/
日常生活能力减退和行为异常	zhengzhuang/rcshnljthxwyc/
日光照射引起皮肤过敏	zhengzhuang/rgzsyqpfgm/
日轻夜重的瘙痒	zhengzhuang/rqyzdsy/
日晒斑	zhengzhuang/rsb_3621/
容貌逐渐变得粗笨	zhengzhuang/rmzjbdcb/
容易发生强迫性症状或疑病观念	zhengzhuang/ryfsqpxzzhybgn/
容易发生青肿	zhengzhuang/ryfsqz/
容易激动	zhengzhuang/ryjd/
容易上火	zhengzhuang/rysh/
溶骨性损害	zhengzhuang/rgxsh/
溶酶体酶缺陷	zhengzhuang/rmtmqx/
溶血	zhengzhuang/rx/
溶血性黄疸	zhengzhuang/rxxhd/
溶血性贫血	zhengzhuang/rxxpx/
肉芽肿	zhengzhuang/ryz/
濡脉	zhengzhuang/rm/
蠕动感	zhengzhuang/rdg/
乳白色尿	zhengzhuang/rbsn/
乳房肥大	zhengzhuang/rffd/
乳房和生殖器萎缩	zhengzhuang/rfhszqws/
乳房红肿热痛	zhengzhuang/rfhzrt/
乳房或乳头未发育	zhengzhuang/rfhrtwfy/
乳房巨大	zhengzhuang/rfjd/
乳房内光滑质韧的球形肿块	zhengzhuang/rfnghzrdqxzk/
乳房硬化	zhengzhuang/rfyh/
乳房早发育	zhengzhuang/rfzfy/
乳房胀痛	zhengzhuang/rfzt/
乳房肿块	zhengzhuang/rfzk/
乳房组织大块坏死	zhengzhuang/rfzzdkhs/
乳糜尿	zhengzhuang/rmn/
乳糜胸	zhengzhuang/rmx/
乳酸蓄积过多	zhengzhuang/rsxjgd/
乳糖耐受不良	zhengzhuang/rtnsbl/
乳痛症	zhengzhuang/rtz/
乳头发炎	zhengzhuang/rtfy/
乳头肥大	zhengzhuang/rtfd/
乳头肌断裂	zhengzhuang/rtjdl/
乳头皲裂	zhengzhuang/rtjl/
乳头内陷	zhengzhuang/rtnx/
乳头破碎	zhengzhuang/rtps/
乳头侵蚀	zhengzhuang/rtqs/
乳头湿疹	zhengzhuang/rtsz/
乳头样增生变化	zhengzhuang/rtyzsbh/
乳头溢出血性或棕色浆液性液体	zhengzhuang/rtycxxhzsjyxyt/
乳头溢液	zhengzhuang/rtyy/
乳头状肿物	zhengzhuang/rtzzw/
乳突炎	zhengzhuang/rty/
乳腺癌的远处转移	zhengzhuang/rxadyczy/
乳腺刺痛	zhengzhuang/rxct/
乳腺发育不良	zhengzhuang/rxfybl/
乳腺肥大	zhengzhuang/rxfd/
乳腺钙化	zhengzhuang/rxgh/
乳腺内无痛单发的硬肿块	zhengzhuang/rxnwtdfdyzk/
乳腺囊性增生	zhengzhuang/rxnxzs/
乳腺随月经出现胀痛	zhengzhuang/rxsyjcxzt/
乳腺退化不全	zhengzhuang/rxthbq/
乳腺外上象限腺体增厚	zhengzhuang/rxwsxxxtzh/
乳腺小叶增生	zhengzhuang/rxxyzs/
乳腺隐痛	zhengzhuang/rxyt/
乳腺胀痛	zhengzhuang/rxzt/
乳腺组织肥厚	zhengzhuang/rxzzfh/
乳溢一高泌乳素血症	zhengzhuang/ryygmrsxz/
乳晕深部可扪及肿块	zhengzhuang/rysbkmjzk/
乳汁分泌减少	zhengzhuang/rzfmjs/
乳汁淤积	zhengzhuang/rzyj/
乳汁郁结	zhengzhuang/rzyj_3683/
入球小动脉玻璃样变	zhengzhuang/rqxdmblyb/
入睡幻觉	zhengzhuang/rshj/
入睡困难	zhengzhuang/rskn/
入睡障碍性失眠	zhengzhuang/rszaxsm/
软产道裂伤	zhengzhuang/rcdls/
软产道异常	zhengzhuang/rcdyc/
软腭浅表溃疡	zhengzhuang/reqbky/
软腭疼痛	zhengzhuang/rett/
软腭有疤痕	zhengzhuang/reybh/
软腭运动不对称	zhengzhuang/reydbdc/
软骨内骨化	zhengzhuang/rgngh/
软组织感染	zhengzhuang/rzzgr/
软组织肿胀	zhengzhuang/rzzzz/
弱脉	zhengzhuang/rm_3697/
弱视眼的拥挤现象	zhengzhuang/rsydyjxx/
蜕膜残留	zhengzhuang/tmcl/
“三怕”(水声、光、风)现象	zhengzhuang/_sp__ss_g_f_xx/
“三偏”症	zhengzhuang/_sp_z/
SM累积量升高	zhengzhuang/smljlsg/
面部水肿	zhengzhuang/mbsz/
腮腺区肿大	zhengzhuang/sxqzd/
腮腺无痛性肿块	zhengzhuang/sxwtxzk/
腮腺肿大	zhengzhuang/sxzd/
腮腺肿胀	zhengzhuang/sxzz/
三凹征	zhengzhuang/saz/
三叉神经分布区麻木感	zhengzhuang/scsjfbqmmg/
三叉神经一二支分布区域疼痛	zhengzhuang/scsjyezfbqytt/
三峰热型	zhengzhuang/sfrx/
三尖瓣脱垂	zhengzhuang/sjbtc/
三尖瓣狭窄	zhengzhuang/sjbxz/
三尖瓣下移	zhengzhuang/sjbxy/
三角肌疼痛	zhengzhuang/sjjtt/
三角韧带损伤	zhengzhuang/sjrdss/
三角头畸形	zhengzhuang/sjtjx/
三联征	zhengzhuang/slz/
散脉	zhengzhuang/sm/
嗓音粗	zhengzhuang/syc/
丧偶后适应性障碍	zhengzhuang/sohsyxza/
瘙痒	zhengzhuang/sy/
色汗	zhengzhuang/sh/
色觉丧失	zhengzhuang/sjss/
色觉异常	zhengzhuang/sjyc/
色情行为	zhengzhuang/sqxw/
色素斑	zhengzhuang/ssb/
色素沉着与色素减退	zhengzhuang/ssczyssjt/
色素脱失	zhengzhuang/ssts/
色素性胆结石	zhengzhuang/ssxdjs/
色素性皮损	zhengzhuang/ssxps/
色素异常	zhengzhuang/ssyc/
涩脉	zhengzhuang/sm_3733/
傻笑	zhengzhuang/sx/
筛窦泪囊瘘	zhengzhuang/sdlnl/
闪电样痛	zhengzhuang/sdyt/
闪回	zhengzhuang/sh_3737/
疝区的疼痛或坠胀感	zhengzhuang/sqdtthzzg/
伤寒面容	zhengzhuang/shmr/
伤口感染	zhengzhuang/skgr/
伤口形成一个搏动性肿块	zhengzhuang/skxcygbdxzk/
伤口愈合发痒	zhengzhuang/skyhfy/
上半身代偿性多汗症	zhengzhuang/sbsdcxdhz/
上半身肥胖型	zhengzhuang/sbsfpx/
上半身热刺激性多汗	zhengzhuang/sbsrcjxdh/
上半身消瘦，下半身肥胖	zhengzhuang/sbsxs_xbsfp/
上臂短于前臂，小腿短于大腿	zhengzhuang/sbdyqb_xtdydt/
上唇变薄	zhengzhuang/scbb/
上唇肥厚	zhengzhuang/scfh/
上唇附近，鼻旁沟和眼睑的丘疹或结节	zhengzhuang/scfj_bpghyjdqzhjj/
上唇疖肿	zhengzhuang/scjz/
上肺纤维化明显	zhengzhuang/sfxwhmx/
上腹壁的中央线缺损	zhengzhuang/sfbdzyxqs/
上腹不适	zhengzhuang/sfbs/
上腹部包块	zhengzhuang/sfbbk/
上腹部疼痛	zhengzhuang/sfbtt/
上腹部肿块及腹胀	zhengzhuang/sfbzkjfz/
上腹及腰背部有“束带感”	zhengzhuang/sfjybby_sdg_/
上腹弥漫性压痛	zhengzhuang/sfmmxyt/
上腹囊性肿块	zhengzhuang/sfnxzk/
上呼吸道和口腔存在大量定植菌	zhengzhuang/shxdhkqczdldzj/
上呼吸道卡他症状	zhengzhuang/shxdktzz/
上呼吸道粘膜刺激症状	zhengzhuang/shxdzmcjzz/
上睑黄白色小点	zhengzhuang/sjhbsxd/
上睑下垂	zhengzhuang/sjxc/
上颈髓区病变	zhengzhuang/sjsqbb/
上列牙痛	zhengzhuang/slyt/
上尿路结构和功能损害	zhengzhuang/snljghgnsh/
上腔静脉回流受阻	zhengzhuang/sqjmhlsz/
上台阶困难	zhengzhuang/stjkn/
上消化道出血	zhengzhuang/sxhdcx/
上行性皮肤麻木	zhengzhuang/sxxpfmm/
上眼睑增厚松弛	zhengzhuang/syjzhsc/
上肢半屈状	zhengzhuang/szbqz/
上肢呈迟缓性麻痹	zhengzhuang/szcchxmb/
上肢及肩向下牵引或手拿重物时疼痛	zhengzhuang/szjjxxqyhsnzwstt/
上肢及面部血管曲张、水肿及青紫	zhengzhuang/szjmbxgqz_szjqz/
上肢麻木	zhengzhuang/szmm/
上肢水肿	zhengzhuang/szsz/
上肢突然出现肿胀酸痛	zhengzhuang/sztrcxzzst/
上肢外展上举困难	zhengzhuang/szwzsjkn/
上肢无力	zhengzhuang/szwl/
上肢周围性瘫痪	zhengzhuang/szzwxth/
烧伤创面暗灰或黑色的坏死斑	zhengzhuang/sscmahhhsdhsb/
烧伤创面苍白或焦黄炭化	zhengzhuang/sscmcbhjhth/
烧伤创面淡黄色粘稠分泌物	zhengzhuang/sscmdhszcfmw/
烧伤创面粪臭味分泌物	zhengzhuang/sscmfcwfmw/
烧伤创面焦痂提前潮解、脱落或出现虫咬样变化	zhengzhuang/sscmjjtqcj_tlhcxcyybh/
烧伤创面浅咖啡色稀薄分泌物	zhengzhuang/sscmqkfsxbfmw/
烧伤创面甜腥气味的粘稠分泌物	zhengzhuang/sscmtxqwdzcfmw/
烧伤后恶心与呕吐	zhengzhuang/sshexyot/
烧伤后口渴	zhengzhuang/sshkk/
烧伤后脉搏增速	zhengzhuang/sshmbzs/
烧伤后尿量减少	zhengzhuang/sshnljs/
烧心	zhengzhuang/sx_3795/
烧灼性疼痛	zhengzhuang/szxtt/
少儿脊柱侧凸	zhengzhuang/sejzct/
少尿	zhengzhuang/sn/
舌背中后部黑色丛毛	zhengzhuang/sbzhbhscm/
舌齿龈疼痛性粟粒至水疱	zhengzhuang/scyttxslzsp/
舌淡体胖	zhengzhuang/sdtp/
舌干苔厚	zhengzhuang/sgth/
舌根部脓肿	zhengzhuang/sgbnz/
舌骨区有肿胀压痛	zhengzhuang/sgqyzzyt/
舌肌麻痹	zhengzhuang/sjmb/
舌肌萎缩	zhengzhuang/sjws/
舌口及咽部烧灼感	zhengzhuang/skjybszg/
舌两侧边缘毛状白斑	zhengzhuang/slcbymzbb/
舌轻度外吐	zhengzhuang/sqdwt/
舌乳头消失	zhengzhuang/srtxs/
舌乳头增生	zhengzhuang/srtzs/
舌苔薄白	zhengzhuang/stbb/
舌苔发黑	zhengzhuang/stfh/
舌苔厚腻	zhengzhuang/sthn/
舌苔黄	zhengzhuang/sth/
舌体大且表面有沟纹	zhengzhuang/stdqbmygw/
舌体肥大	zhengzhuang/stfd/
舌体深裂	zhengzhuang/stsl/
舌痛	zhengzhuang/st/
舌头上有长时间不愈溃疡	zhengzhuang/stsycsjbyky/
舌头震颤	zhengzhuang/stzc/
舌位于口腔底不能外伸	zhengzhuang/swykqdbnws/
舌无力且不能随意伸缩回旋。	zhengzhuang/swlqbnsysshx_/
舌下垂	zhengzhuang/sxc/
舌型骨折	zhengzhuang/sxgz/
舌咽神经损伤	zhengzhuang/sysjss/
舌咽神经痛或其他内脏病引起的晕厥	zhengzhuang/sysjthqtnzbyqdyj/
舌炎	zhengzhuang/sy_3828/
舌咬伤	zhengzhuang/sys/
舌运动受限	zhengzhuang/sydsx/
舌震颤	zhengzhuang/szc_3831/
舌质红绛	zhengzhuang/szhj/
社交恐惧	zhengzhuang/sjkj/
社交敏感性障碍	zhengzhuang/sjmgxza/
射精疼	zhengzhuang/sjt/
伸臂握手疼痛	zhengzhuang/sbwstt/
伸舌偏斜	zhengzhuang/sspx/
伸舌样痴呆	zhengzhuang/ssycd/
伸膝障碍	zhengzhuang/sxza/
伸指无力	zhengzhuang/szwl_3840/
身体“福态”	zhengzhuang/st_ft_/
身体变形障碍	zhengzhuang/stbxza/
身体的低垂部位水肿	zhengzhuang/stddcbwsz/
身体下部短于上部	zhengzhuang/stxbdysb/
身体摇晃征	zhengzhuang/styhz/
身痛	zhengzhuang/st_3846/
呻吟	zhengzhuang/sy_3847/
深部性头痛	zhengzhuang/sbxtt/
深侧鼻塞	zhengzhuang/scbs/
深痱	zhengzhuang/sf/
深感觉障碍	zhengzhuang/sgjza/
深黄色或带绿色的水样便	zhengzhuang/shshdlsdsyb/
深昏迷	zhengzhuang/shm/
深睡眠症	zhengzhuang/ssmz/
神经干断裂	zhengzhuang/sjgdl/
神经根刺激	zhengzhuang/sjgcj/
神经根激惹症状	zhengzhuang/sjgjrzz/
神经根损伤	zhengzhuang/sjgss/
神经官能症状	zhengzhuang/sjgnzz/
神经肌肉症状	zhengzhuang/sjjrzz/
神经伤	zhengzhuang/sjs/
神经失用	zhengzhuang/sjsy/
神经束内神经纤维损伤	zhengzhuang/sjsnsjxwss/
神经束损伤断裂	zhengzhuang/sjsssdl/
神经衰弱综合征	zhengzhuang/sjsrzhz/
神经疼痛	zhengzhuang/sjtt/
神经痛	zhengzhuang/sjt_3867/
神经纤维过度生长	zhengzhuang/sjxwgdsc/
神经性耳聋	zhengzhuang/sjxel/
神经性耳鸣	zhengzhuang/sjxem/
神经性尿频	zhengzhuang/sjxnp/
神经性呕吐	zhengzhuang/sjxot/
神经性头痛	zhengzhuang/sjxtt/
神经性胃痛	zhengzhuang/sjxwt/
神经性厌食	zhengzhuang/sjxys/
神经元移行异常	zhengzhuang/sjyyxyc/
神经症性反应	zhengzhuang/sjzxfy/
神经症性抑郁	zhengzhuang/sjzxyy/
神经质性格	zhengzhuang/sjzxg/
神志不清	zhengzhuang/szbq/
神志淡漠	zhengzhuang/szdm/
神志恍惚	zhengzhuang/szhh/
神志模糊	zhengzhuang/szmh/
肾包膜过度膨胀	zhengzhuang/sbmgdpz/
肾病性浮肿面容	zhengzhuang/sbxfzmr/
肾病综合征	zhengzhuang/sbzhz/
肾部积水现象	zhengzhuang/sbjsxx/
肾动脉狭窄	zhengzhuang/sdmxz/
肾动脉硬化	zhengzhuang/sdmyh/
肾动脉阻塞	zhengzhuang/sdmzs/
肾钙化	zhengzhuang/sgh/
肾功能衰竭	zhengzhuang/sgnsj/
肾后性肾衰	zhengzhuang/shxss/
肾间质受损	zhengzhuang/sjzss/
肾间质水肿	zhengzhuang/sjzsz/
肾间质纤维化	zhengzhuang/sjzxwh/
肾结石	zhengzhuang/sjs_3897/
肾内动脉变细或阻塞	zhengzhuang/sndmbxhzs/
肾浓缩功能障碍	zhengzhuang/snsgnza/
肾脓肿	zhengzhuang/snz/
肾皮质坏死	zhengzhuang/spzhs/
肾气虚	zhengzhuang/sqx/
肾前性肾功能不全	zhengzhuang/sqxsgnbq/
肾区钝痛	zhengzhuang/sqdt/
肾区叩击痛	zhengzhuang/sqkjt/
肾区压痛	zhengzhuang/sqyt/
肾区压痛和叩痛	zhengzhuang/sqythkt/
肾缺血	zhengzhuang/sqx_3908/
肾乳头及肾盂出血	zhengzhuang/srtjsycx/
肾上腺皮质激素不足	zhengzhuang/ssxpzjsbz/
肾上腺皮质良性男性化现象	zhengzhuang/ssxpzlxnxhxx/
肾上腺危象	zhengzhuang/ssxwx/
肾上腺中毒	zhengzhuang/ssxzd/
肾上腺转移	zhengzhuang/ssxzy/
肾衰竭	zhengzhuang/ssj/
肾栓塞	zhengzhuang/sss/
肾损害	zhengzhuang/ssh/
肾外梗阻	zhengzhuang/swgz/
肾无功能	zhengzhuang/swgn/
肾小动脉有纤维梗死	zhengzhuang/sxdmyxwgs/
肾小管坏死	zhengzhuang/sxghs/
肾小管酸化功能障碍	zhengzhuang/sxgshgnza/
肾小管萎陷	zhengzhuang/sxgwx/
肾小管细胞受损后炎症	zhengzhuang/sxgxbsshyz/
肾小管重吸收障碍	zhengzhuang/sxgzxsza/
肾小球基底膜蛾噬现象	zhengzhuang/sxqjdmesxx/
肾小球滤过率下降	zhengzhuang/sxqlglxj/
肾小球内“三高”	zhengzhuang/sxqn_sg_/
肾小球旁器增生	zhengzhuang/sxqpqzs/
肾小球体积增大	zhengzhuang/sxqtjzd/
肾小球硬化	zhengzhuang/sxqyh/
肾小球有病理形态改变	zhengzhuang/sxqyblxtgb/
肾性骨质软化	zhengzhuang/sxgzrh/
肾性尿崩	zhengzhuang/sxnb/
肾性糖尿	zhengzhuang/sxtn/
肾血管畸形	zhengzhuang/sxgjx/
肾阳虚	zhengzhuang/syx/
肾异位伴随输尿管异位	zhengzhuang/sywbssngyw/
肾阴虚	zhengzhuang/syx_3939/
肾阴阳两虚	zhengzhuang/syylx/
肾盂积水	zhengzhuang/syjs/
肾源性水肿	zhengzhuang/syxsz/
肾脏破裂	zhengzhuang/szpl/
肾脏受累	zhengzhuang/szsl/
肾脏缩小	zhengzhuang/szsx/
肾盏变钝	zhengzhuang/szbd/
肾盏结石	zhengzhuang/szjs/
渗出性胸水	zhengzhuang/scxxs/
升主动脉根部环状缩窄	zhengzhuang/szdmgbhzsz/
生长过快	zhengzhuang/scgk/
生长缓慢	zhengzhuang/schm/
生长激素分泌过多	zhengzhuang/scjsfmgd/
生长激素分泌过少	zhengzhuang/scjsfmgs/
生化妊娠	zhengzhuang/shrs/
生理盲点扩大	zhengzhuang/slmdkd/
生理性闭经	zhengzhuang/slxbj/
生理性肥胖	zhengzhuang/slxfp/
生理性腹泻	zhengzhuang/slxfx/
生理性黄疸	zhengzhuang/slxhd/
生理性萎缩	zhengzhuang/slxws/
生理性厌食	zhengzhuang/slxys/
生理性震颤	zhengzhuang/slxzc/
生理性醉酒	zhengzhuang/slxzj/
生命体征改变	zhengzhuang/smtzgb/
生殖泌尿道危象	zhengzhuang/szmndwx/
生殖器外伤	zhengzhuang/szqws/
声带肥厚	zhengzhuang/sdfh/
声带老化	zhengzhuang/sdlh/
声带麻痹	zhengzhuang/sdmb/
声带萎缩	zhengzhuang/sdws/
声调似小孩	zhengzhuang/sdsxh/
声门短而窄	zhengzhuang/smdez/
声门水肿	zhengzhuang/smsz/
声门以上的损伤	zhengzhuang/smysdss/
声门运动障碍	zhengzhuang/smydza/
声音变低	zhengzhuang/sybd/
声音嘶哑	zhengzhuang/sysy/
声音异常	zhengzhuang/syyc/
失读	zhengzhuang/sd/
失眠	zhengzhuang/sm_3980/
失钠多于失水且血清钠浓度低	zhengzhuang/sndyssqxqnndd/
失钠性昏迷	zhengzhuang/snxhm/
失水	zhengzhuang/ss/
失水多于失钠且血清钠浓度高	zhengzhuang/ssdysnqxqnndg/
失血过多	zhengzhuang/sxgd/
失血过多后贫血	zhengzhuang/sxgdhpx/
失盐	zhengzhuang/sy_3987/
失音	zhengzhuang/sy_3988/
失用步态	zhengzhuang/sybt/
失用性综合征	zhengzhuang/syxzhz/
湿咳	zhengzhuang/sk/
湿啰音	zhengzhuang/sly/
湿性坏疽	zhengzhuang/sxhj/
湿性脚气	zhengzhuang/sxjq/
湿性脚气	zhengzhuang/sxjq_3995/
湿性体质	zhengzhuang/sxtz/
湿疹	zhengzhuang/sz/
十二指肠高度扩张	zhengzhuang/sezcgdkz/
十二指肠扩张	zhengzhuang/sezckz/
十二指肠狭窄	zhengzhuang/sezcxz/
十二指肠有切迹或狭窄	zhengzhuang/sezcyqjhxz/
石骨症	zhengzhuang/sgz/
实火	zhengzhuang/sh_4003/
实脉	zhengzhuang/sm_4004/
食道病变	zhengzhuang/sdbb/
食道粘膜水肿充血	zhengzhuang/sdzmszcx/
食管闭锁	zhengzhuang/sgbs/
食管壁纤维化	zhengzhuang/sgbxwh/
食管出血	zhengzhuang/sgcx/
食管对称性膨大	zhengzhuang/sgdcxpd/
食管恶性病变	zhengzhuang/sgexbb/
食管反流症状	zhengzhuang/sgflzz/
食管梗阻	zhengzhuang/sggz/
食管间隙形成肿块	zhengzhuang/sgjxxczk/
食管痉挛	zhengzhuang/sgjl/
食管溃疡	zhengzhuang/sgky/
食管扩张	zhengzhuang/sgkz/
食管瘘	zhengzhuang/sgl/
食管黏膜呈管型剥脱	zhengzhuang/sgnmcgxbt/
食管气管瘘	zhengzhuang/sgqgl/
食管腔梗阻	zhengzhuang/sgqgz/
食管腔狭窄	zhengzhuang/sgqxz/
食管蠕动差扩张及梨状窝钡剂滞留	zhengzhuang/sgrdckzjlzwbjzl/
食管蠕动功能减弱	zhengzhuang/sgrdgnjr/
食管体平滑肌部分蠕动停止	zhengzhuang/sgtphjbfrdtz/
食管下段静脉曲张	zhengzhuang/sgxdjmqz/
食管下括约肌张力下降	zhengzhuang/sgxkyjzlxj/
食管重复	zhengzhuang/sgzf/
食管左壁形成压足跡	zhengzhuang/sgzbxcyzj/
食积口臭	zhengzhuang/sjkc/
食量增加	zhengzhuang/slzj/
食毛后导致的胃肠道症状	zhengzhuang/smhdzdwcdzz/
食物返流至鼻腔	zhengzhuang/swflzbq/
食物过敏	zhengzhuang/swgm/
食物误入气道	zhengzhuang/swwrqd/
食物下咽时颈部有气过水声感	zhengzhuang/swxysjbyqgssg/
食物在胃的通过障碍	zhengzhuang/swzwdtgza/
食欲不振	zhengzhuang/sybz/
食欲减退	zhengzhuang/syjt/
食欲较差	zhengzhuang/syjc/
食欲缺乏	zhengzhuang/syqf/
食欲下降	zhengzhuang/syxj/
食欲异常	zhengzhuang/syyc_4043/
食指半月甲呈粉红色	zhengzhuang/szbyjcfhs/
食指不明原因疼痛	zhengzhuang/szbmyytt/
食指感觉消失	zhengzhuang/szgjxs/
食指和中指僵硬痛麻	zhengzhuang/szhzzjytm/
食指指甲凹陷	zhengzhuang/szzjax/
始基子宫	zhengzhuang/sjzg/
始于眼部，扩张开来的面头痛	zhengzhuang/syyb_kzkldmtt/
视近不能持久	zhengzhuang/sjbncj/
视近困难	zhengzhuang/sjkn/
视觉失认	zhengzhuang/sjsr/
视觉识别障碍性眩晕	zhengzhuang/sjsbzaxxy/
视空间功能受损	zhengzhuang/skjgnss/
视力常呈雾状模糊感	zhengzhuang/slccwzmhg/
视力视野改变	zhengzhuang/slsygb/
视力障碍	zhengzhuang/slza/
视盘倾斜	zhengzhuang/spqx/
视乳头水肿	zhengzhuang/srtsz/
视神经的原发性萎缩	zhengzhuang/ssjdyfxws/
视神经乳头苍白	zhengzhuang/ssjrtcb/
视神经萎缩	zhengzhuang/ssjws/
视网膜Roth斑	zhengzhuang/swmrothb/
视网膜出血	zhengzhuang/swmcx/
视网膜动脉阻塞	zhengzhuang/swmdmzs/
视网膜静脉纡曲怒张	zhengzhuang/swmjmyqnz/
视网膜水肿	zhengzhuang/swmsz/
视网膜脱离	zhengzhuang/swmtl/
视物变小	zhengzhuang/swbx/
视物变形	zhengzhuang/swbx_4071/
视野缺损	zhengzhuang/syqs/
视野缩小	zhengzhuang/sysx/
视野向心性缩小	zhengzhuang/syxxxsx/
室颤	zhengzhuang/sc/
室颤阈值降低	zhengzhuang/scyzjd/
室间隔缺损	zhengzhuang/sjgqs/
室上性心律失常	zhengzhuang/ssxxlsc/
室性早搏	zhengzhuang/sxzb/
嗜红细胞综合征	zhengzhuang/shxbzhz/
嗜酒	zhengzhuang/sj/
嗜酒性幻觉性精神错乱	zhengzhuang/sjxhjxjscl/
嗜睡	zhengzhuang/ss_4083/
嗜酸细胞增加	zhengzhuang/ssxbzj/
嗜酸性粒细胞增多	zhengzhuang/ssxlxbzd/
嗜心性病毒感染	zhengzhuang/sxxbdgr/
嗜盐	zhengzhuang/sy_4087/
收缩期反流性杂音	zhengzhuang/ssqflxzy/
收缩期和舒张期杂音	zhengzhuang/ssqhszqzy/
收缩期杂音	zhengzhuang/ssqzy/
收缩期震颤	zhengzhuang/ssqzc/
收缩压下降	zhengzhuang/ssyxj/
收缩早期喀喇音	zhengzhuang/sszqkly/
手、足部厚壁水疱	zhengzhuang/s_zbhbsp/
手背部皮肤发红肿胀	zhengzhuang/sbbpffhzz/
手臂肌肉拉伤	zhengzhuang/sbjrls/
手臂肌肉萎缩	zhengzhuang/sbjrws/
手变短	zhengzhuang/sbd/
手表皮深处的水疱	zhengzhuang/sbpscdsp/
手部功能完全丧失	zhengzhuang/sbgnwqss/
手部急性化脓性感染	zhengzhuang/sbjxhnxgr/
手部震颤	zhengzhuang/sbzc/
手抽筋	zhengzhuang/scj/
手唇震颤	zhengzhuang/sczc/
手的搓丸样动作	zhengzhuang/sdcwydz/
手的歪扭畸形	zhengzhuang/sdwnjx/
手冻伤	zhengzhuang/sds/
手机依赖症	zhengzhuang/sjylz/
手肌肉萎缩	zhengzhuang/sjrws/
手脚冰凉	zhengzhuang/sjbl/
手凉	zhengzhuang/sl/
手麻	zhengzhuang/sm_4112/
手内肌萎缩	zhengzhuang/snjws/
手皮肤发紫	zhengzhuang/spffz/
手热	zhengzhuang/sr/
手上有小水泡	zhengzhuang/ssyxsp/
手势性自动症	zhengzhuang/ssxzdz/
手术创伤	zhengzhuang/sscs/
手术后破伤风	zhengzhuang/sshpsf/
手术时伤口不再出血	zhengzhuang/sssskbzcx/
手酸	zhengzhuang/ss_4121/
手套或短袜子式浅、深感觉障碍	zhengzhuang/sthdwzsq_sgjza/
手脱皮	zhengzhuang/stp/
手腕部米粒大小硬如软骨的包块	zhengzhuang/swbmldxyrrgdbk/
手腕长骨刺	zhengzhuang/swcgc/
手腕在大拇指侧的疼痛	zhengzhuang/swzdmzcdtt/
手腕肿痛及掌屈活动受限	zhengzhuang/swztjzqhdsx/
手握物无力	zhengzhuang/swwwl/
手无力不自觉的丢落持物	zhengzhuang/swlbzjddlcw/
手下垂时皮肤呈灰蓝色	zhengzhuang/sxcspfchls/
手小形方	zhengzhuang/sxxf/
手与手指胀满感	zhengzhuang/syszzmg/
手掌疤痕畸形	zhengzhuang/szbhjx/
手掌呈黑色	zhengzhuang/szchs/
手掌呈黄色	zhengzhuang/szchs_4135/
手掌和足底角化伴多汗	zhengzhuang/szhzdjhbdh/
手掌及足底发红	zhengzhuang/szjzdfh/
手掌及足趾皮肤过度角化	zhengzhuang/szjzzpfgdjh/
手掌软硬度异常	zhengzhuang/szrydyc/
手掌硬性水肿	zhengzhuang/szyxsz/
手震颤	zhengzhuang/szc_4141/
手指不能屈伸	zhengzhuang/szbnqs/
手指冻肿	zhengzhuang/szdz/
手指发绀或坏死	zhengzhuang/szfghhs/
手指发僵疼痛	zhengzhuang/szfjtt/
手指和足趾无痛性软组织肿块	zhengzhuang/szhzzwtxrzzzk/
手指或手臂部刺痛及麻木感	zhengzhuang/szhsbbctjmmg/
手指甲没有白色月牙	zhengzhuang/szjmybsyy/
手指甲有白色斑点	zhengzhuang/szjybsbd/
手指甲周围起皮	zhengzhuang/szjzwqp/
手指尖痛或触痛	zhengzhuang/szjthct/
手指麻痛	zhengzhuang/szmt/
手指末端持续对称性刺痛麻木	zhengzhuang/szmdcxdcxctmm/
手指扭伤	zhengzhuang/szns/
手指痛风	zhengzhuang/sztf/
手指歪斜	zhengzhuang/szwx/
手指香肠型	zhengzhuang/szxcx/
手指小关节痛肿	zhengzhuang/szxgjtz/
手指撞伤	zhengzhuang/szzs/
手足多汗	zhengzhuang/szdh/
手足发抖	zhengzhuang/szfd/
手足皲裂	zhengzhuang/szjl/
手足麻木	zhengzhuang/szmm_4163/
手足脱皮	zhengzhuang/sztp/
受伤后易产生瘢痕	zhengzhuang/sshycsbh/
书写痉挛	zhengzhuang/sxjl/
梳头或洗头时头发脱落增加	zhengzhuang/sthxtstftlzj/
舒张期奔马律	zhengzhuang/szqbml/
舒张期哈气样杂音	zhengzhuang/szqhqyzy/
舒张期震颤	zhengzhuang/szqzc/
舒张晚期奔马律	zhengzhuang/szwqbml/
舒张压上升	zhengzhuang/szyss/
输精管变粗	zhengzhuang/sjgbc/
输精管堵塞	zhengzhuang/sjgds/
输精管疼痛	zhengzhuang/sjgtt/
输卵管粘连	zhengzhuang/slgzl/
输卵管肿大	zhengzhuang/slgzd/
输卵管肿块	zhengzhuang/slgzk/
输尿管梗阻	zhengzhuang/snggz/
输尿管间脊肥大	zhengzhuang/sngjjfd/
输尿管痉挛	zhengzhuang/sngjl/
输尿管扩张	zhengzhuang/sngkz/
输尿管囊肿	zhengzhuang/sngnz/
输尿管疼痛	zhengzhuang/sngtt/
输尿管狭窄	zhengzhuang/sngxz/
输尿管向心偏移	zhengzhuang/sngxxpy/
输乳管阻塞	zhengzhuang/srgzs/
鼠尾征	zhengzhuang/swz/
鼠疫样皮损	zhengzhuang/syyps/
术后发热	zhengzhuang/shfr/
术后腹胀	zhengzhuang/shfz/
术后急性精神障碍	zhengzhuang/shjxjsza/
术后疼痛	zhengzhuang/shtt/
束臂试验阳性	zhengzhuang/sbsyyx/
数脉	zhengzhuang/sm_4195/
数目较多的咖啡牛奶斑	zhengzhuang/smjddkfnnb/
刷牙出血	zhengzhuang/sycx/
衰老加快	zhengzhuang/sljk/
衰弱	zhengzhuang/sr_4199/
栓塞性肾炎	zhengzhuang/ssxsy/
双侧睑外翻	zhengzhuang/scjwf/
双侧肾内痛	zhengzhuang/scsnt/
双侧肾上腺皮质增生	zhengzhuang/scssxpzzs/
双侧手足徐动	zhengzhuang/scszxd/
双侧下腹坠痛	zhengzhuang/scxfzt/
双耳廓发育不全	zhengzhuang/sekfybq/
双耳廓缺损	zhengzhuang/sekqs/
双肺的吸气爆裂音	zhengzhuang/sfdxqbly/
双肺水泡音	zhengzhuang/sfspy/
双颊凹陷呈猴腮状	zhengzhuang/sjaxchsz/
双胫对称发生梅核大小疼痛性结节	zhengzhuang/sjdcfsmhdxttxjj/
双眉间长痘	zhengzhuang/smjcd/
双乳间距增宽	zhengzhuang/srjjzk/
双上眼睑的水肿性紫红色斑	zhengzhuang/ssyjdszxzhsb/
双肾弥漫性病变	zhengzhuang/ssmmxbb/
双肾皮质变薄	zhengzhuang/sspzbb/
双手活动软弱无力	zhengzhuang/sshdrrwl/
双手轮替动作笨拙	zhengzhuang/ssltdzbz/
双手震颤	zhengzhuang/sszc/
双胎静脉吻合	zhengzhuang/stjmwh/
双吸气	zhengzhuang/sxq/
双下肢可凹陷性水肿	zhengzhuang/sxzkaxxsz/
双下肢突然性瘫痪	zhengzhuang/sxztrxth/
双相型体温	zhengzhuang/sxxtw/
双眼Bell现象不对称	zhengzhuang/sybellxxbdc/
双眼抽搐	zhengzhuang/sycc/
双眼眶距宽	zhengzhuang/sykjk/
双眼难以忍受的奇痒	zhengzhuang/synyrsdqy/
双眼向上凝视	zhengzhuang/syxsns/
双掌猿线出现率增加和atd角增大	zhengzhuang/szyxcxlzjhatdjzd/
双足红肿热痛	zhengzhuang/szhzrt/
水、钠潴留性肥胖症	zhengzhuang/s_nzlxfpz/
水冲脉	zhengzhuang/scm/
水痘结痂	zhengzhuang/sdjj/
水痘样皮疹	zhengzhuang/sdypz/
水咳	zhengzhuang/sk_4236/
水母头征	zhengzhuang/smtz/
水钠的蓄积	zhengzhuang/sndxj/
水泡	zhengzhuang/sp/
水泡性烧伤	zhengzhuang/spxss/
水疱或大疱损害	zhengzhuang/sphdpsh/
水疱或大疱损害	zhengzhuang/sphdpsh_4242/
水平掌褶纹(通贯手)	zhengzhuang/spzzw_tgs_/
水泻伴低血钾	zhengzhuang/sxbdxj/
水盐代谢障碍	zhengzhuang/sydxza/
水样便	zhengzhuang/syb/
水中毒	zhengzhuang/szd/
水中毒性昏迷	zhengzhuang/szdxhm/
水肿	zhengzhuang/sz_4249/
水肿伴蛋白尿	zhengzhuang/szbdbn/
水肿伴呼吸困难、紫绀	zhengzhuang/szbhxkn_zg/
水潴留	zhengzhuang/szl/
睡过之后精力没有恢复	zhengzhuang/sgzhjlmyhf/
睡后手指出现麻木或烧灼痛而致醒	zhengzhuang/shszcxmmhsztezx/
睡觉背部酸痛	zhengzhuang/sjbbst/
睡觉后全身大汗淋漓	zhengzhuang/sjhqsdhll/
睡觉流口水	zhengzhuang/sjlks/
睡觉时突然抽搐一下	zhengzhuang/sjstrccyx/
睡觉时小腿抽筋	zhengzhuang/sjsxtcj/
睡觉时心跳加快	zhengzhuang/sjsxtjk/
睡眠猝死	zhengzhuang/smcs/
睡眠过度	zhengzhuang/smgd/
睡眠呼吸暂停	zhengzhuang/smhxzt/
睡眠唤醒反应	zhengzhuang/smhxfy/
睡眠节律紊乱	zhengzhuang/smjlwl/
睡眠-觉醒时间程序的障碍	zhengzhuang/sm_jxsjcxdza/
睡眠麻痹	zhengzhuang/smmb/
睡眠时间倒错	zhengzhuang/smsjdc/
睡眠时睑闭合不全	zhengzhuang/smsjbhbq/
睡眠障碍	zhengzhuang/smza/
睡眠中周期性腿动	zhengzhuang/smzzqxtd/
睡瘫症	zhengzhuang/stz/
睡行症	zhengzhuang/sxz/
顺行性遗忘	zhengzhuang/sxxyw/
说话带鼻音	zhengzhuang/shdby/
说话时字词不能连续	zhengzhuang/shszcbnlx/
思考困难感	zhengzhuang/skkng/
思虑伤脾	zhengzhuang/slsp/
思维奔逸	zhengzhuang/swby/
思维不连贯	zhengzhuang/swblg/
思维缓慢	zhengzhuang/swhm/
思维解体	zhengzhuang/swjt/
思维控制异常	zhengzhuang/swkzyc/
思维黏滞	zhengzhuang/swnz/
思维贫乏	zhengzhuang/swpf/
思维破裂	zhengzhuang/swpl/
思维松弛	zhengzhuang/swsc/
思维紊乱	zhengzhuang/swwl/
思维中断	zhengzhuang/swzd/
撕脱骨折	zhengzhuang/stgz/
死产	zhengzhuang/sc_4291/
死骨	zhengzhuang/sg/
死精子过多	zhengzhuang/sjzgd/
死胎	zhengzhuang/st_4294/
四边孔处的局限压痛	zhengzhuang/sbkcdjxyt/
四叠体受压	zhengzhuang/sdtsy/
四音心律	zhengzhuang/syxl/
四肢长骨和肌肉无规律的酸痛	zhengzhuang/szcghjrwgldst/
四肢呈对称性下运动神经元性瘫痪	zhengzhuang/szcdcxxydsjyxth/
四肢抽搐	zhengzhuang/szcc/
四肢电击感	zhengzhuang/szdjg/
四肢对称性软瘫	zhengzhuang/szdcxrt/
四肢发冷	zhengzhuang/szfl/
四肢肌张力增强	zhengzhuang/szjzlzq/
四肢畸形	zhengzhuang/szjx/
四肢近端肌肉和呼吸麻痹	zhengzhuang/szjdjrhhxmb/
四肢麻木	zhengzhuang/szmm_4307/
四肢屈侧出现橘皮样外观	zhengzhuang/szqccxjpywg/
四肢湿冷	zhengzhuang/szsl_4309/
四肢酸痛无力	zhengzhuang/szstwl/
四肢苔藓样变	zhengzhuang/sztxyb/
四肢瘫痪	zhengzhuang/szth/
四肢无力	zhengzhuang/szwl_4313/
四肢血压脉搏不对称	zhengzhuang/szxymbbdc/
四肢远端麻木、疼痛或异样感觉	zhengzhuang/szydmm_tthyygj/
四肢震颤	zhengzhuang/szzc/
松果体钙化移位	zhengzhuang/sgtghyw/
松果体区占位病变	zhengzhuang/sgtqzwbb/
耸肩喘息	zhengzhuang/sjcx/
诉讼狂	zhengzhuang/ssk/
速脉	zhengzhuang/sm_4321/
粟粒样丘疹	zhengzhuang/slyqz/
酸烧伤	zhengzhuang/sss_4323/
髓核脱水	zhengzhuang/shts/
髓鞘化延迟	zhengzhuang/sqhyc/
髓性纤维化	zhengzhuang/sxxwh/
髓样癌变	zhengzhuang/syab/
髓质海绵肾	zhengzhuang/szhms/
髓质增生	zhengzhuang/szzs_4329/
缩瞳、眼睑下垂及眼球内陷	zhengzhuang/st_yjxcjyqnx/
缩窄性心包炎	zhengzhuang/szxxby/
锁骨上的搏动性肿块	zhengzhuang/sgsdbdxzk/
锁骨上及前斜角肌淋巴结肿大	zhengzhuang/sgsjqxjjlbjzd/
锁合畸形	zhengzhuang/shjx/
胎儿窘迫	zhengzhuang/tejp/
胎儿生长发育迟缓	zhengzhuang/tescfych/
言语功能的部分丧失	zhengzhuang/yygndbfss/
阴囊瘙痒	zhengzhuang/ynsy/
胎儿宫内骨折	zhengzhuang/tegngz/
Todd瘫痪（遗留暂时性局部肢体的瘫痪或无力）	zhengzhuang/toddth_ylzsxjbztdthhwl_/
T波低平或倒置	zhengzhuang/tbdphdz/
弹钢琴指(趾)征	zhengzhuang/dgqz_z_z/
胎动改变	zhengzhuang/tdgb/
胎动过频	zhengzhuang/tdgp/
胎动频繁	zhengzhuang/tdpf/
胎儿不完全臀先露	zhengzhuang/tebwqtxl/
胎儿单臂先露	zhengzhuang/tedbxl/
胎儿宫内发育迟缓	zhengzhuang/tegnfych/
胎儿宫内窒息	zhengzhuang/tegnzx/
胎儿酒精综合征	zhengzhuang/tejjzhz/
胎儿水肿	zhengzhuang/tesz/
胎儿心动过缓	zhengzhuang/texdgh/
胎粪污染	zhengzhuang/tfwr/
胎毛多	zhengzhuang/tmd/
胎膜破裂	zhengzhuang/tmpl/
胎膜早破	zhengzhuang/tmzp/
胎盘大	zhengzhuang/tpd/
胎盘钙化	zhengzhuang/tpgh/
胎盘老化	zhengzhuang/tplh/
胎盘母体面上有凝血块及压迹	zhengzhuang/tpmtmsynxkjyj/
胎盘前置	zhengzhuang/tpqz/
胎盘血液灌注不良	zhengzhuang/tpxygzbl/
胎盘早剥	zhengzhuang/tpzb/
胎盘植入	zhengzhuang/tpzr/
胎盘滞留宫腔	zhengzhuang/tpzlgq/
胎势异常	zhengzhuang/tsyc/
胎位不正	zhengzhuang/twbz/
胎位异常	zhengzhuang/twyc/
胎心不规则	zhengzhuang/txbgz/
胎心率改变	zhengzhuang/txlgb/
胎心率异常	zhengzhuang/txlyc/
胎心音消失（无胎心音）	zhengzhuang/txyxs_wtxy_/
胎样心音	zhengzhuang/tyxy/
胎痣	zhengzhuang/tz/
抬肩以助呼吸	zhengzhuang/tjyzhx/
抬举性搏动	zhengzhuang/tjxbd/
苔黄腻	zhengzhuang/thn/
太阳穴痛	zhengzhuang/tyxt/
太阳穴胀痛	zhengzhuang/tyxzt/
贪食	zhengzhuang/ts/
贪食行为	zhengzhuang/tsxw/
瘫痪	zhengzhuang/th/
痰呈白色黏稠胶冻状	zhengzhuang/tcbsncjdz/
痰呈粘液脓性	zhengzhuang/tczynx/
痰检或可找到丝状蚴	zhengzhuang/tjhkzdszy/
痰检阴性	zhengzhuang/tjyx/
痰鸣音	zhengzhuang/tmy/
痰黏稠或脓性可有腥臭味	zhengzhuang/tnchnxkyxcw/
痰湿体质	zhengzhuang/tstz/
痰饮	zhengzhuang/ty/
痰有恶臭味	zhengzhuang/tyecw/
痰中带血丝	zhengzhuang/tzdxs/
痰中或可找到蛔蚴或虫卵	zhengzhuang/tzhkzdhyhcl/
叹气后舒服	zhengzhuang/tqhsf/
叹息样呼吸	zhengzhuang/txyhx/
糖代谢紊乱	zhengzhuang/tdxwl/
糖类皮质激素分泌过多	zhengzhuang/tlpzjsfmgd/
糖类皮质激素分泌过少	zhengzhuang/tlpzjsfmgs/
糖耐量降低	zhengzhuang/tnljd/
糖尿	zhengzhuang/tn/
糖尿病皮肤病变	zhengzhuang/tnbpfbb/
糖尿病酮症酸中毒	zhengzhuang/tnbtzszd/
烫伤	zhengzhuang/ts_4403/
烫伤后汗腺受损	zhengzhuang/tshhxss/
烫伤水泡破了	zhengzhuang/tssppl/
陶奇感染	zhengzhuang/tqgr/
陶瑟征阳性	zhengzhuang/tszyx/
特别容易饿	zhengzhuang/tbrye/
特禀体质	zhengzhuang/tbtz/
特发性水肿	zhengzhuang/tfxsz/
特殊面痣	zhengzhuang/tsmz/
特异性氨基酸尿	zhengzhuang/tyxajsn/
特征性回归热	zhengzhuang/tzxhgr/
特征性趾端大片状脱皮	zhengzhuang/tzxzddpztp/
特重烧伤	zhengzhuang/tzss/
疼痛弧征	zhengzhuang/tthz/
疼痛性股白肿	zhengzhuang/ttxgbz/
疼痛性股青肿	zhengzhuang/ttxgqz/
锑性皮炎	zhengzhuang/txpy/
体肺循环栓塞	zhengzhuang/tfxhss/
体毛脱落	zhengzhuang/tmtl/
体内水钠潴留	zhengzhuang/tnsnzl/
体位性眩晕	zhengzhuang/twxxy/
体位性震颤	zhengzhuang/twxzc/
体位张力消失	zhengzhuang/twzlxs/
体温调节紊乱	zhengzhuang/twdjwl/
体温过低	zhengzhuang/twgd/
体象障碍	zhengzhuang/txza/
体型异常	zhengzhuang/txyc/
体癣	zhengzhuang/tx/
体循环淤血	zhengzhuang/txhyx/
体液外渗	zhengzhuang/tyws/
体液潴留	zhengzhuang/tyzl/
体重减轻	zhengzhuang/tzjq/
体重增加	zhengzhuang/tzzj/
挑剔嘴	zhengzhuang/ttz/
铁锈色痰	zhengzhuang/txst/
听不懂别人及自己说的话	zhengzhuang/tbdbrjzjsdh/
听骨畸形	zhengzhuang/tgjx/
听觉过敏	zhengzhuang/tjgm/
听觉疲劳	zhengzhuang/tjpl/
听觉障碍	zhengzhuang/tjza/
听力减退	zhengzhuang/tljt/
听力缺陷	zhengzhuang/tlqx/
听力下降	zhengzhuang/tlxj/
听阈上升	zhengzhuang/tyss/
停经	zhengzhuang/tj/
停经并溢乳	zhengzhuang/tjbyr/
停经过早	zhengzhuang/tjgz/
停止排气	zhengzhuang/tzpq/
通贯掌	zhengzhuang/tgz/
同位素32磷吸收试验阳性	zhengzhuang/tws32lxssyyx/
同向偏盲	zhengzhuang/txpm/
同向性偏盲	zhengzhuang/txxpm/
童样痴呆	zhengzhuang/tycd/
酮尿	zhengzhuang/tn_4456/
酮症酸中毒	zhengzhuang/tzszd/
瞳孔变白	zhengzhuang/tkbb/
瞳孔变形	zhengzhuang/tkbx/
瞳孔不对称	zhengzhuang/tkbdc/
瞳孔出现黄白色反光	zhengzhuang/tkcxhbsfg/
瞳孔大小不等	zhengzhuang/tkdxbd/
瞳孔固定	zhengzhuang/tkgd/
瞳孔两侧不等大	zhengzhuang/tklcbdd/
瞳孔如锯齿或梅花状	zhengzhuang/tkrjchmhz/
瞳孔异常	zhengzhuang/tkyc/
瞳孔缘色素外翻	zhengzhuang/tkysswf/
瞳孔中能见到白色反光	zhengzhuang/tkznjdbsfg/
瞳子高	zhengzhuang/tzg/
桶状胸	zhengzhuang/tzx/
痛风结节	zhengzhuang/tfjj/
痛经	zhengzhuang/tj_4472/
痛觉与温度觉减退而压觉存在	zhengzhuang/tjywdjjteyjcz/
痛性红舌	zhengzhuang/txhs/
痛性溃疡和渗出恶臭的黄绿色脓液	zhengzhuang/txkyhscecdhlsny/
痛性脸抽搐	zhengzhuang/txlcc/
痛性阴茎勃起	zhengzhuang/txyjbq/
痛阈降低	zhengzhuang/tyjd/
头部呈钝痛，无搏动性	zhengzhuang/tbcdt_wbdx/
头部及眼后部疼痛并能听到连续不断的隆隆声	zhengzhuang/tbjyhbttbntdlxbddlls/
头部偏向一侧做扭转运动	zhengzhuang/tbpxycznzyd/
头部震颤	zhengzhuang/tbzc/
头部撞伤	zhengzhuang/tbzs/
头沉	zhengzhuang/tc/
头大畸形	zhengzhuang/tdjx/
头顶重压发紧	zhengzhuang/tdzyfj/
头发淡黄色	zhengzhuang/tfdhs/
头发分叉	zhengzhuang/tffc/
头发枯黄稀疏	zhengzhuang/tfkhxs/
头昏	zhengzhuang/th_4490/
头昏想睡觉	zhengzhuang/thxsj/
头昏眼花	zhengzhuang/thyh/
头或颈部发胀及跳动感	zhengzhuang/thjbfzjtdg/
头颈部活动受限	zhengzhuang/tjbhdsx/
头颈部剧痛	zhengzhuang/tjbjt/
头颈分离感	zhengzhuang/tjflg/
头颅骨病变	zhengzhuang/tlgbb/
头颅向上生长呈塔形	zhengzhuang/tlxsscctx/
头颅增大	zhengzhuang/tlzd/
头目晕沉	zhengzhuang/tmyc/
头盆不称	zhengzhuang/tpbc/
头皮不规则裂口	zhengzhuang/tpbgzlk/
头皮触痛	zhengzhuang/tpct/
头皮坏死	zhengzhuang/tphs/
头皮结痂	zhengzhuang/tpjj/
头皮平直裂口	zhengzhuang/tppzlk/
头皮瘙痒剧烈并有血痂	zhengzhuang/tpsyjlbyxj/
头皮撕裂伤	zhengzhuang/tpsls/
头皮撕脱伤	zhengzhuang/tpsts/
头皮松垂	zhengzhuang/tpsc/
头皮下血肿	zhengzhuang/tpxxz/
头皮屑多	zhengzhuang/tpxd/
头皮血肿	zhengzhuang/tpxz/
头皮痒	zhengzhuang/tpy/
头跳痛	zhengzhuang/ttt/
头痛	zhengzhuang/tt/
头痛并呕吐	zhengzhuang/ttbot/
头痛为搏动性	zhengzhuang/ttwbdx/
头摇	zhengzhuang/ty_4519/
头晕	zhengzhuang/ty_4520/
头胀	zhengzhuang/tz_4521/
头枕部慢性疼痛	zhengzhuang/tzbmxtt/
头重足轻	zhengzhuang/tzzq/
投掷动作(颤搐)	zhengzhuang/tzdz_cc_/
透明血管型	zhengzhuang/tmxgx/
凸腭	zhengzhuang/te/
凸甲	zhengzhuang/tj_4527/
突发、无痛的局部水肿	zhengzhuang/tf_wtdjbsz/
突发的右侧心衰	zhengzhuang/tfdycxs/
突发的左心衰竭	zhengzhuang/tfdzxsj/
突发性绞痛	zhengzhuang/tfxjt/
突发性疼痛	zhengzhuang/tfxtt/
突发性右上腹绞痛	zhengzhuang/tfxysfjt/
突肤挺胸	zhengzhuang/tftx/
突然出现剧烈的腰痛	zhengzhuang/trcxjldyt/
突眼症	zhengzhuang/tyz/
图形定向障碍	zhengzhuang/txdxza/
吐白沫痰	zhengzhuang/tbmt/
吐弄舌	zhengzhuang/tns/
吐酸	zhengzhuang/ts_4540/
兔唇	zhengzhuang/tc_4541/
推髌抗阻痛	zhengzhuang/tbkzt/
腿脚抽筋	zhengzhuang/tjcj/
腿脚浮肿	zhengzhuang/tjfz/
腿前内侧出现感觉异常	zhengzhuang/tqnccxgjyc/
腿外侧质软、半球形、界限清的弹性包块	zhengzhuang/twczr_bqx_jxqddxbk/
腿外侧质软半球形包块	zhengzhuang/twczrbqxbk/
退离休综合症	zhengzhuang/tlxzhz/
蜕膜反应	zhengzhuang/tmfy/
褪黑色素增多	zhengzhuang/thsszd/
吞气	zhengzhuang/tq/
吞酸	zhengzhuang/ts_4552/
吞咽发呛	zhengzhuang/tyfq/
吞咽干食物时胸骨后有阻塞感或钝痛	zhengzhuang/tygswsxghyzsghdt/
吞咽困难	zhengzhuang/tykn/
吞咽时发生晕厥	zhengzhuang/tysfsyj/
吞咽时胸痛	zhengzhuang/tysxt/
吞咽痛	zhengzhuang/tyt/
吞咽障碍	zhengzhuang/tyza/
臀部放射痛	zhengzhuang/tbfst/
臀部可触及上移的股骨头	zhengzhuang/tbkcjsydggt/
臀部闪电疼痛	zhengzhuang/tbsdtt/
臀部酸痛	zhengzhuang/tbst/
臀部疼痛	zhengzhuang/tbtt/
臀产式	zhengzhuang/tcs/
臀沟内似夹着异物样的难受及不愉快感	zhengzhuang/tgnsjzywydnsjbykg/
臀沟下垂状跛行步态	zhengzhuang/tgxczbxbt/
臀沟展平和下垂	zhengzhuang/tgzphxc/
臀肌挛缩	zhengzhuang/tjls/
臀肌萎缩	zhengzhuang/tjws/
臀中肌麻痹步态	zhengzhuang/tzjmbbt/
臀中肌损伤	zhengzhuang/tzjss/
脱发	zhengzhuang/tf/
脱肛	zhengzhuang/tg/
脱皮	zhengzhuang/tp/
脱水	zhengzhuang/ts_4576/
脱水热	zhengzhuang/tsr/
脱髓	zhengzhuang/ts_4578/
脱症	zhengzhuang/tz_4579/
驼背	zhengzhuang/tb/
唾液分泌增多	zhengzhuang/tyfmzd/
唾液及汗液减少	zhengzhuang/tyjhyjs/
唾液腺肿大	zhengzhuang/tyxzd/
站立久后的浮肿	zhengzhuang/zljhdfz/
“5P”征	zhengzhuang/_5p_z/
毛发色淡而呈棕色	zhengzhuang/mfsdeczs/
挖鼻孔	zhengzhuang/wbk/
挖耳出血	zhengzhuang/wecx/
蛙形腹	zhengzhuang/wxf/
蛙状鼻	zhengzhuang/wzb/
歪鼻	zhengzhuang/wb/
歪斜指	zhengzhuang/wxz/
外耳道疼痛	zhengzhuang/wedtt/
外耳道狭窄	zhengzhuang/wedxz/
外耳道癣	zhengzhuang/wedx/
外斐氏试验阴性	zhengzhuang/wfssyyx/
外踝呈现凹陷	zhengzhuang/whcxax/
外踝前下方肿胀和疼痛	zhengzhuang/whqxfzzhtt/
外貌苍老	zhengzhuang/wmcl/
外伤性出血	zhengzhuang/wsxcx/
外伤性低位截瘫	zhengzhuang/wsxdwjt/
外伤性遗忘症	zhengzhuang/wsxywz/
外斜A征	zhengzhuang/wxaz/
外斜V征	zhengzhuang/wxvz/
外眼源性眩晕	zhengzhuang/wyyxxy/
外阴白斑	zhengzhuang/wybb/
外阴呈幼稚型无阴毛	zhengzhuang/wycyzxwym/
外阴溃疡	zhengzhuang/wyky/
外阴鳞状上皮疣状增生	zhengzhuang/wylzspyzzs/
外阴皮肤肿胀	zhengzhuang/wypfzz/
外阴烧灼刺激感	zhengzhuang/wyszcjg/
外阴损伤	zhengzhuang/wyss/
外阴痛	zhengzhuang/wyt/
外阴萎缩	zhengzhuang/wyws/
外阴下坠感	zhengzhuang/wyxzg/
外阴压痛	zhengzhuang/wyyt/
外阴幼稚	zhengzhuang/wyyz/
外阴肿胀	zhengzhuang/wyzz/
外展型骨折	zhengzhuang/wzxgz/
外周静脉充勇	zhengzhuang/wzjmcy/
外周围血淋巴细胞浆有空泡	zhengzhuang/wzwxlbxbjykp/
外周血管减少	zhengzhuang/wzxgjs/
关节僵硬	zhengzhuang/gjjy_4623/
弯腰时腰痛	zhengzhuang/wysyt/
完全流产	zhengzhuang/wqlc/
完全性遗忘症	zhengzhuang/wqxywz/
顽固性便秘	zhengzhuang/wgxbm/
顽固性呃逆	zhengzhuang/wgxen/
顽固性肥胖	zhengzhuang/wgxfp/
顽固性高血压	zhengzhuang/wgxgxy/
顽固性口腔溃疡	zhengzhuang/wgxkqky/
顽固性失眠	zhengzhuang/wgxsm/
顽固性疼痛	zhengzhuang/wgxtt/
顽固性头痛	zhengzhuang/wgxtt_4634/
顽固性心功能不全	zhengzhuang/wgxxgnbq/
晚发月经	zhengzhuang/wfyj/
晚上睡觉出冷汗	zhengzhuang/wssjclh/
晚霞样或夕照样眼底	zhengzhuang/wxyhxzyyd/
脘痞	zhengzhuang/wp/
腕背侧或掌侧的脓肿或窦道	zhengzhuang/wbchzcdnzhdd/
腕部疼痛	zhengzhuang/wbtt/
腕部肿胀压痛	zhengzhuang/wbzzyt/
腕骨发育不全变形及掌骨呈棒状改变	zhengzhuang/wgfybqbxjzgcbzgb/
腕关节结节样的突起	zhengzhuang/wgjjjydtq/
腕关节内积血及活动受限	zhengzhuang/wgjnjxjhdsx/
腕关节囊状的突起	zhengzhuang/wgjnzdtq/
腕关节扭挫伤	zhengzhuang/wgjncs/
腕关节桡侧部位的疼痛	zhengzhuang/wgjrcbwdtt/
腕关节向尺侧偏斜时桡侧出现剧痛	zhengzhuang/wgjxccpxsrccxjt/
腕关节圆形的软包块	zhengzhuang/wgjyxdrbk/
腕管综合征	zhengzhuang/wgzhz/
腕枪刺状畸形	zhengzhuang/wqczjx/
腕下垂	zhengzhuang/wxc/
腕银叉状畸形	zhengzhuang/wyczjx/
腕征	zhengzhuang/wz/
网络依赖	zhengzhuang/wlyl/
网络综合症	zhengzhuang/wlzhz/
网膜囊肿扭转	zhengzhuang/wmnznz/
网球肘	zhengzhuang/wqz/
网眼样痴呆	zhengzhuang/wyycd/
网状青斑	zhengzhuang/wzqb/
网状青斑和坏疽	zhengzhuang/wzqbhhj/
网状色素沉着斑	zhengzhuang/wzssczb/
忘性大	zhengzhuang/wxd/
望诊无明显心前区搏动	zhengzhuang/wzwmxxqqbd/
微量元素缺少	zhengzhuang/wlysqs/
微脉	zhengzhuang/wm/
微血管溶血性贫血	zhengzhuang/wxgrxxpx/
微血管心绞痛	zhengzhuang/wxgxjt/
微循环灌注不良	zhengzhuang/wxhgzbl/
微循环障碍	zhengzhuang/wxhza/
微炎症状态	zhengzhuang/wyzzt/
韦氏环	zhengzhuang/wsh/
围产期心肌病变	zhengzhuang/wcqxjbb/
违拗症	zhengzhuang/waz/
维生素B12吸收不良	zhengzhuang/wssb12xsbl/
维生素B1缺乏	zhengzhuang/wssb1qf/
维生素B族缺乏	zhengzhuang/wssbzqf/
维生素C缺乏	zhengzhuang/wsscqf/
维生素D缺乏	zhengzhuang/wssdqf/
维生素D中毒	zhengzhuang/wssdzd/
维生素E缺乏	zhengzhuang/wsseqf/
维生素K缺乏	zhengzhuang/wsskqf/
维生素缺乏	zhengzhuang/wssqf/
尾部疼痛而拒坐	zhengzhuang/wbttejz/
尾部中线有细小凹坑但无任何感觉	zhengzhuang/wbzxyxxakdwrhgj/
尾骶部疼痛	zhengzhuang/wdbtt/
尾骨压痛及异常活动	zhengzhuang/wgytjychd/
萎缩性痤疮	zhengzhuang/wsxcc/
猥亵行为	zhengzhuang/wxxw/
未分化躯体形式障碍	zhengzhuang/wfhqtxsza/
位置觉、震动觉减退	zhengzhuang/wzj_zdjjt/
味觉减退	zhengzhuang/wjjt/
畏光	zhengzhuang/wg/
畏光及流泪	zhengzhuang/wgjll/
畏寒	zhengzhuang/wh/
畏热	zhengzhuang/wr/
胃壁肌层缺损	zhengzhuang/wbjcqs/
胃壁僵硬	zhengzhuang/wbjy/
胃部隐痛	zhengzhuang/wbyt/
胃肠道出血	zhengzhuang/wcdcx/
胃肠道功能不好	zhengzhuang/wcdgnbh/
胃肠道排空表现	zhengzhuang/wcdpkbx/
胃肠道淤血	zhengzhuang/wcdyx/
胃肠道胀气	zhengzhuang/wcdzq/
胃肠道症状	zhengzhuang/wcdzz/
胃肠动力差	zhengzhuang/wcdlc/
胃肠感冒	zhengzhuang/wcgm/
胃肠功能不良	zhengzhuang/wcgnbl/
胃肠扩张与脱肛	zhengzhuang/wckzytg/
胃肠淋巴回流受阻	zhengzhuang/wclbhlsz/
胃肠气胀	zhengzhuang/wcqz/
胃肠粘膜的通透性增高	zhengzhuang/wczmdttxzg/
胃丢失蛋白	zhengzhuang/wdsdb/
胃窦动力低下	zhengzhuang/wddldx/
胃窦狭窄	zhengzhuang/wdxz/
胃寒疼痛	zhengzhuang/whtt/
胃火	zhengzhuang/wh_4718/
胃火口臭	zhengzhuang/whkc/
胃痉挛	zhengzhuang/wjl/
胃镜下表现出广泛黏膜红斑	zhengzhuang/wjxbxcgfnmhb/
胃扩张	zhengzhuang/wkz/
胃慢性出血	zhengzhuang/wmxcx/
胃糜烂	zhengzhuang/wml/
胃内翻腾或搅拌感	zhengzhuang/wnfthjbg/
胃内压增加	zhengzhuang/wnyzj/
胃内有异物	zhengzhuang/wnyyw/
胃纳差症状	zhengzhuang/wnczz/
胃纳减退	zhengzhuang/wnjt/
胃黏膜充血水肿	zhengzhuang/wnmcxsz/
胃扭转梗阻症状	zhengzhuang/wnzgzzz/
胃排空过快	zhengzhuang/wpkgk/
胃排空延缓	zhengzhuang/wpkyh/
胃气虚	zhengzhuang/wqx/
胃嵌顿	zhengzhuang/wqd/
胃区包块	zhengzhuang/wqbk/
胃热疼痛	zhengzhuang/wrtt/
胃容纳性减弱	zhengzhuang/wrnxjr/
胃石形成	zhengzhuang/wsxc/
胃食管反流症状	zhengzhuang/wsgflzz/
胃酸过多	zhengzhuang/wsgd/
胃酸减少	zhengzhuang/wsjs/
胃酸缺乏	zhengzhuang/wsqf/
胃痛	zhengzhuang/wt/
胃脘饱胀	zhengzhuang/wwbz/
胃危象	zhengzhuang/wwx/
胃移位	zhengzhuang/wyw/
胃阴虚	zhengzhuang/wyx/
胃粘膜呈萎缩性改变	zhengzhuang/wzmcwsxgb/
胃粘膜充血	zhengzhuang/wzmcx/
胃粘膜损伤	zhengzhuang/wzmss/
胃粘膜脱垂	zhengzhuang/wzmtc/
胃粘膜增粗	zhengzhuang/wzmzc/
胃重复畸形	zhengzhuang/wzfjx/
胃灼热	zhengzhuang/wzr/
喂食困难	zhengzhuang/wskn/
温结节	zhengzhuang/wjj/
温觉丧失	zhengzhuang/wjss/
温醒现象	zhengzhuang/wxxx/
蚊虫刺咬炎症	zhengzhuang/wccyyz/
吻合口并发症	zhengzhuang/whkbfz/
卧床不起	zhengzhuang/wcbq/
握力减退	zhengzhuang/wljt/
无胆汁粪便	zhengzhuang/wdzfb/
无动性缄默	zhengzhuang/wdxjm/
无法数清每分钟脉搏次数	zhengzhuang/wfsqmfzmbcs/
无法引出moro反应	zhengzhuang/wfycmorofy/
无睾丸	zhengzhuang/wgw/
无宫缩间歇	zhengzhuang/wgsjx/
无故发笑	zhengzhuang/wgfx/
无汗腺导管角质护膜分化	zhengzhuang/whxdgjzhmfh/
无胡须	zhengzhuang/whx/
无胡须腋毛和阴毛	zhengzhuang/whxymhym/
无活动性结核病灶	zhengzhuang/whdxjhbz/
无晶状体眼	zhengzhuang/wjzty/
无菌性赘生物	zhengzhuang/wjxzsw/
无力	zhengzhuang/wl/
无脉症	zhengzhuang/wmz/
无名指半月甲呈粉红色	zhengzhuang/wmzbyjcfhs/
无名指不明原因疼痛	zhengzhuang/wmzbmyytt/
无名指指甲凹陷	zhengzhuang/wmzzjax/
无目的咀嚼舐唇	zhengzhuang/wmdjjsc/
无能力感	zhengzhuang/wnlg/
无尿	zhengzhuang/wn/
无瘙痒，无肝胆疾病的皮肤黄染	zhengzhuang/wsy_wgdjbdpfhr/
无痛性口腔溃疡	zhengzhuang/wtxkqky/
无痛性尿血	zhengzhuang/wtxnx/
无痛性阴囊内肿块	zhengzhuang/wtxynnzk/
无痛性硬实结节	zhengzhuang/wtxysjj/
无羞惭感	zhengzhuang/wxcg/
无嗅脑	zhengzhuang/wxn/
无腋毛	zhengzhuang/wym/
无用感	zhengzhuang/wyg/
无欲-运动不能-意志缺乏综合征	zhengzhuang/wy_ydbn_yzqfzhz/
无月经来潮	zhengzhuang/wyjlc/
无运动或感觉障碍的运用不能	zhengzhuang/wydhgjzadyybn/
无症状型溃疡	zhengzhuang/wzzxky/
无症状性菌尿	zhengzhuang/wzzxjn/
无助感	zhengzhuang/wzg/
五志化火	zhengzhuang/wzhh/
舞蹈病样动作	zhengzhuang/wdbydz/
舞蹈样不自主运动	zhengzhuang/wdybzzyd/
舞蹈样步态	zhengzhuang/wdybt/
舞蹈样手足徐动	zhengzhuang/wdyszxd/
雾视	zhengzhuang/ws/
心胃的奇怪感觉	zhengzhuang/xwdqggj/
婴儿需要较大量的维生素B6	zhengzhuang/yexyjdldwssb6/
X型腿	zhengzhuang/xxt/
XA-现象	zhengzhuang/xa_xx/
XV-现象	zhengzhuang/xv_xx/
X-现象	zhengzhuang/x_xx/
杵状指（趾）	zhengzhuang/czz_z_/
儿童胸廓变形	zhengzhuang/etxkbx/
鳞屑样痂皮	zhengzhuang/lxyjp/
湿疣	zhengzhuang/sy_4815/
室性自主节律	zhengzhuang/sxzzjl/
微血栓形成	zhengzhuang/wxsxc/
夕阳综合征	zhengzhuang/xyzhz/
吸气困难	zhengzhuang/xqkn/
吸气时鼻腔阻塞	zhengzhuang/xqsbqzs/
吸气时出现连枷胸	zhengzhuang/xqscxljx/
吸气时上气道陷闭	zhengzhuang/xqssqdxb/
吸气时胸口痛	zhengzhuang/xqsxkt/
吸气时有蝉鸣音	zhengzhuang/xqsycmy/
吸入综合征	zhengzhuang/xrzhz/
吸收不良综合征	zhengzhuang/xsblzhz/
吸吮反射消失	zhengzhuang/xsfsxs/
吸吮反射阳性	zhengzhuang/xsfsyx/
吸烟胸痛	zhengzhuang/xyxt/
息肉	zhengzhuang/xr/
息肉样损害	zhengzhuang/xrysh/
硒缺乏	zhengzhuang/xqf/
稀便	zhengzhuang/xb/
膝、踝反射减退	zhengzhuang/x_hfsjt/
膝盖长骨刺	zhengzhuang/xgcgc/
膝盖扭伤	zhengzhuang/xgns/
膝盖砸伤肿痛	zhengzhuang/xgzszt/
膝盖撞伤	zhengzhuang/xgzs/
膝关节不能完全伸直	zhengzhuang/xgjbnwqsz/
膝关节积液	zhengzhuang/xgjjy/
膝关节间隙弹响和疼痛	zhengzhuang/xgjjxdxhtt/
膝关节内侧肿胀青紫，局部剧痛	zhengzhuang/xgjnczzqz_jbjt/
膝关节软弱无力	zhengzhuang/xgjrrwl/
膝关节疼痛	zhengzhuang/xgjtt/
膝关节肿大	zhengzhuang/xgjzd/
膝关节肿胀积血	zhengzhuang/xgjzzjx/
膝后疼痛	zhengzhuang/xhtt/
膝后肿胀疼痛，活动受限	zhengzhuang/xhzztt_hdsx/
膝及小腿部有广泛的瘀血斑	zhengzhuang/xjxtbygfdyxb/
膝腱反射消失	zhengzhuang/xjfsxs/
膝内翻	zhengzhuang/xnf/
膝内翻膝外翻或髋内翻	zhengzhuang/xnfxwfhknf/
膝前疼痛	zhengzhuang/xqtt/
习惯性便秘	zhengzhuang/xgxbm/
习惯性腹泻	zhengzhuang/xgxfx/
习惯性流产	zhengzhuang/xgxlc/
习惯性尿裤	zhengzhuang/xgxnk/
习惯性脱臼	zhengzhuang/xgxtj/
习惯性下巴脱臼	zhengzhuang/xgxxbtj/
喜凉怕热	zhengzhuang/xlpr/
喜怒无常	zhengzhuang/xnwc/
系统性血管炎	zhengzhuang/xtxxgy/
细胞感染增大	zhengzhuang/xbgrzd/
细胞色素C氧化酶缺乏症	zhengzhuang/xbsscyhmqfz/
细胞外液减少	zhengzhuang/xbwyjs/
细胞外液渗透压增高	zhengzhuang/xbwystyzg/
细菌的混合感染	zhengzhuang/xjdhhgr/
细菌感染	zhengzhuang/xjgr/
细菌性心内膜炎	zhengzhuang/xjxxnmy/
细颗粒管型	zhengzhuang/xklgx/
细网状到斑片状的色素沉着	zhengzhuang/xwzdbpzdsscz/
细小黄色瘤状皮疹	zhengzhuang/xxhslzpz/
狭窄骨盆	zhengzhuang/xzgp/
狭窄杂音	zhengzhuang/xzzy/
下巴长痘	zhengzhuang/xbcd/
下巴关节疼	zhengzhuang/xbgjt/
下半身无汗或少汗	zhengzhuang/xbswhhsh/
下半身消瘦型	zhengzhuang/xbsxsx/
下背部僵硬和疼痛	zhengzhuang/xbbjyhtt/
下背部酸痛	zhengzhuang/xbbst/
下鼻甲或中鼻甲肥大	zhengzhuang/xbjhzbjfd/
下垂肩	zhengzhuang/xcj/
下垂乳房	zhengzhuang/xcrf/
下唇麻木	zhengzhuang/xcmm/
下唇微痒增大如蚕茧硬结	zhengzhuang/xcwyzdrcjyj/
下唇肿胀外翻	zhengzhuang/xczzwf/
下蹲困难	zhengzhuang/xdkn/
下肺代偿性气肿	zhengzhuang/xfdcxqz/
下腹部包块	zhengzhuang/xfbbk/
下腹部钝痛和酸胀感	zhengzhuang/xfbdthszg/
下腹部反跳痛	zhengzhuang/xfbftt/
下腹部压痛	zhengzhuang/xfbyt/
下腹绞痛	zhengzhuang/xfjt/
下腹局部疼痛	zhengzhuang/xfjbtt/
下腹剧痛并渐向腹中线扩散	zhengzhuang/xfjtbjxfzxks/
下腹疼痛	zhengzhuang/xftt/
下腹痛	zhengzhuang/xft/
下腹胀痛	zhengzhuang/xfzt/
下腹坠痛	zhengzhuang/xfzt_4899/
下腹坠胀	zhengzhuang/xfzz/
下颌后缩	zhengzhuang/xhhs/
下颌角外翻	zhengzhuang/xhjwf/
下颌前突	zhengzhuang/xhqt/
下睑外翻	zhengzhuang/xjwf/
下腔静脉血栓形成	zhengzhuang/xqjmxsxc/
下丘脑损害	zhengzhuang/xqnsh/
下身肥胖	zhengzhuang/xsfp/
下消化道少量出血	zhengzhuang/xxhdslcx/
下腰部疼痛	zhengzhuang/xybtt/
下肢呈剪刀步态	zhengzhuang/xzcjdbt/
下肢的感觉，肌力，神经异常	zhengzhuang/xzdgj_jl_sjyc/
下肢动作沉重，高抬足，重落地	zhengzhuang/xzdzcz_gtz_zld/
下肢短缩	zhengzhuang/xzds/
下肢发凉	zhengzhuang/xzfl/
下肢放射痛	zhengzhuang/xzfst/
下肢负重障碍	zhengzhuang/xzfzza/
下肢感应痛或放射痛的腰背痛	zhengzhuang/xzgythfstdybt/
下肢红斑结节	zhengzhuang/xzhbjj/
下肢或周身软瘫	zhengzhuang/xzhzsrt/
下肢肌肉瘫痪	zhengzhuang/xzjrth/
下肢久立时出现膨胀性剧烈疼痛	zhengzhuang/xzjlscxpzxjltt/
下肢弥漫性水肿	zhengzhuang/xzmmxsz/
下肢皮肤营养性改变	zhengzhuang/xzpfyyxgb/
下肢浅静脉曲张	zhengzhuang/xzqjmqz/
下肢神经性疼痛	zhengzhuang/xzsjxtt/
下肢湿性坏疽	zhengzhuang/xzsxhj/
下肢水肿	zhengzhuang/xzsz/
下肢拖曳步态	zhengzhuang/xztybt/
下肢外展	zhengzhuang/xzwz/
下肢无力	zhengzhuang/xzwl/
下肢血压偏低	zhengzhuang/xzxypd/
下肢振动觉和位置觉受损	zhengzhuang/xzzdjhwzjss/
下肢中枢性瘫痪	zhengzhuang/xzzsxth/
下肢肿胀和乏力	zhengzhuang/xzzzhfl/
夏季厌食症	zhengzhuang/xjysz/
夏季痒疹	zhengzhuang/xjyz/
先天性X因子缺乏	zhengzhuang/xtxxyzqf/
先天性腹壁发育不全	zhengzhuang/xtxfbfybq/
先天性弓形体	zhengzhuang/xtxgxt/
先天性骨发育不良	zhengzhuang/xtxgfybl/
先天性虹膜缺乏	zhengzhuang/xtxhmqf/
先天性乳糖不耐受	zhengzhuang/xtxrtbns/
先天性乳糖酶缺乏	zhengzhuang/xtxrtmqf/
先天性少白头	zhengzhuang/xtxsbt/
先天性铜代谢障碍	zhengzhuang/xtxtdxza/
先天性无虹膜	zhengzhuang/xtxwhm/
先天性无阴道	zhengzhuang/xtxwyd/
先天性无子宫	zhengzhuang/xtxwzg/
先天性心脏传导	zhengzhuang/xtxxzcd/
先兆流产	zhengzhuang/xzlc/
先兆早产	zhengzhuang/xzzc/
先兆子宫破裂	zhengzhuang/xzzgpl/
先兆子痫	zhengzhuang/xzzx/
纤毛结构缺陷	zhengzhuang/xmjgqx/
纤毛清除功能障碍	zhengzhuang/xmqcgnza/
纤毛上皮细胞损伤脱落	zhengzhuang/xmspxbsstl/
纤维结构不良	zhengzhuang/xwjgbl/
纤维渗出物	zhengzhuang/xwscw/
纤维性钙化结节	zhengzhuang/xwxghjj/
鲜红斑痣	zhengzhuang/xhbz/
鲜红色乳头状赘生物突向尿道腔	zhengzhuang/xhsrtzzswtxndq/
鲜红掌	zhengzhuang/xhz/
弦脉	zhengzhuang/xm/
现实解体	zhengzhuang/xsjt/
线状骨折	zhengzhuang/xzgz/
腺体结节	zhengzhuang/xtjj/
腺性或囊性膀胱炎	zhengzhuang/xxhnxbgy/
腺样体面容	zhengzhuang/xytmr/
霰粒肿	zhengzhuang/xlz/
向心性肥胖	zhengzhuang/xxxfp/
象限性偏盲	zhengzhuang/xxxpm/
消耗性体重下降	zhengzhuang/xhxtzxj/
消化不良	zhengzhuang/xhbl/
消化道穿孔	zhengzhuang/xhdck/
消化道激惹	zhengzhuang/xhdjr/
消化道内毛石或毛粪石形成	zhengzhuang/xhdnmshmfsxc/
消化道憩室	zhengzhuang/xhdqs/
消化道狭窄	zhengzhuang/xhdxz/
消化管蠕动不协调	zhengzhuang/xhgrdbxd/
消化性溃疡	zhengzhuang/xhxky/
消瘦	zhengzhuang/xs/
消瘦严重者呈”皮包骨头”样	zhengzhuang/xsyzzc_pbgt_y/
小便不易排空	zhengzhuang/xbbypk/
小便恐惧	zhengzhuang/xbkj/
小步态	zhengzhuang/xbt/
小肠扩张充气	zhengzhuang/xckzcq/
小肠内的低pH	zhengzhuang/xcnddph/
小肠损伤	zhengzhuang/xcss/
小肠危象	zhengzhuang/xcwx/
小肠细菌过度生长	zhengzhuang/xcxjgdsc/
小胆管扭曲	zhengzhuang/xdgnq/
小儿爱咬指甲	zhengzhuang/xeayzj/
小儿便秘	zhengzhuang/xebm/
小儿的异嗜症状	zhengzhuang/xedyszz/
小儿发热	zhengzhuang/xefr/
小儿干咳	zhengzhuang/xegk/
小儿疳积	zhengzhuang/xegj/
小儿进食易呕吐	zhengzhuang/xejsyot/
小儿剧烈咳嗽	zhengzhuang/xejlks/
小儿咳嗽	zhengzhuang/xeks/
小儿哭闹不安	zhengzhuang/xeknba/
小儿流口水	zhengzhuang/xelks/
小儿明显瘦小	zhengzhuang/xemxsx/
小儿尿色发蓝	zhengzhuang/xensfl/
小儿尿血	zhengzhuang/xenx/
小儿青盲	zhengzhuang/xeqm/
小儿上火	zhengzhuang/xesh/
小儿生理性贫血	zhengzhuang/xeslxpx/
小儿声带损伤	zhengzhuang/xesdss/
小儿双下肢蜷曲	zhengzhuang/xesxzqq/
小儿腿抽筋	zhengzhuang/xetcj/
小儿维生素D缺乏	zhengzhuang/xewssdqf/
小儿痒疹	zhengzhuang/xeyz/
小儿曳足而行	zhengzhuang/xeyzex/
小儿夜惊咬指	zhengzhuang/xeyjyz/
小儿夜啼	zhengzhuang/xeyt/
小儿遗尿	zhengzhuang/xeyn/
小儿右上腹阵发性绞痛	zhengzhuang/xeysfzfxjt/
小腹刺痛	zhengzhuang/xfct/
小腹冷痛	zhengzhuang/xflt/
小管毒性病变	zhengzhuang/xgdxbb/
小管间质性肾炎	zhengzhuang/xgjzxsy/
小管萎缩病变	zhengzhuang/xgwsbb/
小孩频繁眨眼	zhengzhuang/xhpfzy/
小颌	zhengzhuang/xh/
小梁网色素沉着	zhengzhuang/xlwsscz/
小脑出血	zhengzhuang/xncx/
小脑定向力和功能障碍	zhengzhuang/xndxlhgnza/
小脑功能损害	zhengzhuang/xngnsh/
小脑畸形	zhengzhuang/xnjx/
小脑失调症	zhengzhuang/xnsdz/
小脑-视网膜综合征	zhengzhuang/xn_swmzhz/
小脑体征	zhengzhuang/xntz/
小脑性共济失调	zhengzhuang/xnxgjsd/
小三阳	zhengzhuang/xsy/
小书写症	zhengzhuang/xsxz/
小头	zhengzhuang/xt/
小腿肚抽筋	zhengzhuang/xtdcj/
小腿发胀	zhengzhuang/xtfz/
小腿腓部肌肉疼痛和压痛	zhengzhuang/xtfbjrtthyt/
小腿和踝关节周围的紫红色瘀斑	zhengzhuang/xthhgjzwdzhsyb/
小腿或前臂间隙综合征	zhengzhuang/xthqbjxzhz/
小腿肌肉萎缩	zhengzhuang/xtjrws/
小腿溃疡	zhengzhuang/xtky/
小腿内侧感觉丧失	zhengzhuang/xtncgjss/
小腿瘙痒干燥	zhengzhuang/xtsygz/
小腿水肿	zhengzhuang/xtsz/
小腿酸痛	zhengzhuang/xtst/
小腿外侧及足背感觉丧失	zhengzhuang/xtwcjzbgjss/
小腿下部色素沉着、脱屑、湿疹	zhengzhuang/xtxbsscz_tx_sz/
小腿以下缺血	zhengzhuang/xtyxqx/
小腿肿胀疼痛	zhengzhuang/xtzztt/
小胃综合征	zhengzhuang/xwzhz/
小血管纤维性坏死	zhengzhuang/xxgxwxhs/
小眼球	zhengzhuang/xyq/
小阴唇及前庭也有散在的白色圆形及环形丘疹	zhengzhuang/xycjqtyyszdbsyxjhxqz/
小支气管痉挛	zhengzhuang/xzqgjl/
小支气管平滑肌挛缩	zhengzhuang/xzqgphjls/
小支气管粘膜水肿	zhengzhuang/xzqgzmsz/
小指半月甲呈粉红色	zhengzhuang/xzbyjcfhs/
小指不明原因痛	zhengzhuang/xzbmyyt/
小指单一褶纹	zhengzhuang/xzdyzw/
小指感觉消失	zhengzhuang/xzgjxs/
小指指甲有凹陷	zhengzhuang/xzzjyax/
哮鸣音	zhengzhuang/xmy/
斜视	zhengzhuang/xs_5066/
斜视性弱视	zhengzhuang/xsxrs/
斜头畸形	zhengzhuang/xtjx/
斜形骨折	zhengzhuang/xxgz/
斜眼抑制	zhengzhuang/xyyz/
写字或拿小物品困难	zhengzhuang/xzhnxwpkn/
泻药性便秘	zhengzhuang/xyxbm/
心瓣膜病变	zhengzhuang/xbmbb/
心瓣膜穿孔	zhengzhuang/xbmck/
心包积液	zhengzhuang/xbjy/
心包积液体征	zhengzhuang/xbjytz/
心包膜发炎	zhengzhuang/xbmfy/
心包内出血	zhengzhuang/xbncx/
心包破损伤	zhengzhuang/xbpss/
心包缩窄	zhengzhuang/xbsz/
心包填塞	zhengzhuang/xbts/
心包纤维增厚	zhengzhuang/xbxwzh/
心包压塞	zhengzhuang/xbys/
心包炎	zhengzhuang/xby/
心包转移	zhengzhuang/xbzy/
心搏漏跳	zhengzhuang/xblt/
心电图异常	zhengzhuang/xdtyc/
心动过缓	zhengzhuang/xdgh/
心动过速	zhengzhuang/xdgs/
心房对心室收缩的辅助泵作用丧失	zhengzhuang/xfdxsssdfzbzyss/
心房内形成混合血	zhengzhuang/xfnxchhx/
心房游走性节律	zhengzhuang/xfyzxjl/
心肺栓塞	zhengzhuang/xfss/
心功能失代偿	zhengzhuang/xgnsdc/
心慌	zhengzhuang/xh_5095/
心慌气短	zhengzhuang/xhqd/
心火	zhengzhuang/xh_5097/
心肌冬眠现象	zhengzhuang/xjdmxx/
心肌顿抑	zhengzhuang/xjdy/
心肌肥厚	zhengzhuang/xjfh/
心肌梗死	zhengzhuang/xjgs/
心肌耗氧量增加	zhengzhuang/xjhylzj/
心肌坏死广泛	zhengzhuang/xjhsgf/
心肌灰白而松弛	zhengzhuang/xjhbesc/
心肌脓肿	zhengzhuang/xjnz/
心肌缺氧	zhengzhuang/xjqy/
心肌细胞的浊肿	zhengzhuang/xjxbdzz/
心肌营养障碍	zhengzhuang/xjyyza/
心悸	zhengzhuang/xj/
心悸伴乏力、面色苍白	zhengzhuang/xjbfl_mscb/
心悸伴高血压	zhengzhuang/xjbgxy/
心悸伴消瘦、腹泻	zhengzhuang/xjbxs_fx/
心悸伴心率异常	zhengzhuang/xjbxlyc/
心尖搏动弥散	zhengzhuang/xjbdms/
心尖部第1心音亢进	zhengzhuang/xjbd1xykj/
心绞痛	zhengzhuang/xjt/
心境不良	zhengzhuang/xjbl/
心境高涨	zhengzhuang/xjgz/
心口灼热痛	zhengzhuang/xkzrt/
心理老化	zhengzhuang/xllh/
心理麻木	zhengzhuang/xlmm/
心理年龄大于生理年龄	zhengzhuang/xlnldyslnl/
心理年龄小于生理年龄	zhengzhuang/xlnlxyslnl/
心理伤害	zhengzhuang/xlsh/
心理性性功能障碍	zhengzhuang/xlxxgnza/
心力衰竭	zhengzhuang/xlsj/
心力贮备减少	zhengzhuang/xlzbjs/
心律失常	zhengzhuang/xlsc/
心率不齐	zhengzhuang/xlbq/
心率过缓	zhengzhuang/xlgh/
心率增快	zhengzhuang/xlzk/
心内分流为右向左	zhengzhuang/xnflwyxz/
心内膜弹力纤维增生	zhengzhuang/xnmdlxwzs/
心脑血管意外	zhengzhuang/xnxgyw/
心排血量减少	zhengzhuang/xpxljs/
心排血量增多	zhengzhuang/xpxlzd/
心前区隆起	zhengzhuang/xqqlq/
心前区隐痛	zhengzhuang/xqqyt/
心室肥大	zhengzhuang/xsfd/
心室扑动	zhengzhuang/xspd/
心室纤颤	zhengzhuang/xsxc/
心跳过速	zhengzhuang/xtgs/
心跳很乱	zhengzhuang/xthl/
心跳加快	zhengzhuang/xtjk/
心窝部隐痛	zhengzhuang/xwbyt/
心血管造影见双球征	zhengzhuang/xxgzyjsqz/
心音低钝	zhengzhuang/xydd/
心音及脉搏消失	zhengzhuang/xyjmbxs/
心音微弱	zhengzhuang/xywr/
心音遥远	zhengzhuang/xyyy/
心音异常	zhengzhuang/xyyc/
心源性呼吸窘迫	zhengzhuang/xyxhxjp/
心源性呼吸困难	zhengzhuang/xyxhxkn/
心源性水肿	zhengzhuang/xyxsz/
心源性胸痛	zhengzhuang/xyxxt/
心源性晕厥	zhengzhuang/xyxyj/
心脏“偷停”感	zhengzhuang/xz_tt_g/
心脏病引发的晕厥	zhengzhuang/xzbyfdyj/
心脏穿透性损伤	zhengzhuang/xzctxss/
心脏刺痛	zhengzhuang/xzct/
心脏毒性作用	zhengzhuang/xzdxzy/
心脏肥大	zhengzhuang/xzfd/
心脏复苏	zhengzhuang/xzfs/
心脏功能突然失代偿	zhengzhuang/xzgntrsdc/
心脏畸形	zhengzhuang/xzjx/
心脏僵硬	zhengzhuang/xzjy/
心脏结构异常	zhengzhuang/xzjgyc/
心脏扩大	zhengzhuang/xzkd/
心脏排血受阻	zhengzhuang/xzpxsz/
心脏破裂	zhengzhuang/xzpl/
心脏失代偿	zhengzhuang/xzsdc/
心脏停搏	zhengzhuang/xztb/
心脏性猝死	zhengzhuang/xzxcs/
心脏压塞征象	zhengzhuang/xzyszx/
心脏淤积淀粉样物质	zhengzhuang/xzyjdfywz/
心脏杂音	zhengzhuang/xzzy_5176/
心脏增大	zhengzhuang/xzzd/
心脏震颤	zhengzhuang/xzzc_5178/
心脏重量增加	zhengzhuang/xzzlzj/
心脏骤停	zhengzhuang/xzzt/
心脏转移	zhengzhuang/xzzy_5181/
新陈代谢低下	zhengzhuang/xcdxdx/
新陈代谢旺盛	zhengzhuang/xcdxws/
新生儿便秘	zhengzhuang/xsebm/
新生儿抽搐	zhengzhuang/xsecc/
新生儿出血症	zhengzhuang/xsecxz/
新生儿蛋白尿	zhengzhuang/xsedbn/
新生儿低体温	zhengzhuang/xsedtw/
新生儿低血磷	zhengzhuang/xsedxl/
新生儿发绀	zhengzhuang/xsefg/
新生儿反应低下	zhengzhuang/xsefydx/
新生儿喉喘鸣	zhengzhuang/xsehcm/
新生儿两眼上翻凝视	zhengzhuang/xselysfns/
新生儿绿牙或棕褐色牙	zhengzhuang/xselyhzhsy/
新生儿母乳喂养后出现黄疸	zhengzhuang/xsemrwyhcxhd/
新生儿脓漏眼	zhengzhuang/xsenly/
新生儿皮肤薄	zhengzhuang/xsepfb/
新生儿皮肤硬肿	zhengzhuang/xsepfyz/
新生儿皮肤褶皱	zhengzhuang/xsepfzz/
新生儿贫血	zhengzhuang/xsepx/
新生儿破伤风	zhengzhuang/xsepsf/
新生儿期癫痫持续状态	zhengzhuang/xseqdxcxzt/
新生儿脐部出血	zhengzhuang/xseqbcx/
新生儿气促	zhengzhuang/xseqc/
新生儿青紫	zhengzhuang/xseqz/
新生儿全身水肿	zhengzhuang/xseqssz/
新生儿少吃	zhengzhuang/xsesc/
新生儿少哭	zhengzhuang/xsesk/
新生儿嗜睡	zhengzhuang/xsess/
新生儿手足徐动	zhengzhuang/xseszxd/
新生儿吮乳无力及减少	zhengzhuang/xsesrwljjs/
新生儿心力衰竭	zhengzhuang/xsexlsj/
新生儿震颤	zhengzhuang/xsezc/
新生儿中性粒细胞增多	zhengzhuang/xsezxlxbzd/
新月状溶骨性缺损	zhengzhuang/xyzrgxqs/
信息成瘾	zhengzhuang/xxcy/
星迹步态	zhengzhuang/xjbt/
猩红热面容	zhengzhuang/xhrmr/
猩红热样皮疹	zhengzhuang/xhrypz/
行为动作幼稚愚蠢	zhengzhuang/xwdzyzyc/
行为及情绪异常	zhengzhuang/xwjqxyc/
行为紊乱而奇特	zhengzhuang/xwwleqt/
行为无计划性	zhengzhuang/xwwjhx/
行走踩棉花感	zhengzhuang/xzcmhg/
行走呈大步态	zhengzhuang/xzcdbt/
行走后小腿肌肉痉挛	zhengzhuang/xzhxtjrjl/
行走时发生腓肠肌麻木	zhengzhuang/xzsfsfcjmm/
醒后不解乏	zhengzhuang/xhbjf/
性倒错	zhengzhuang/xdc/
性发育慢	zhengzhuang/xfym/
性发育停顿	zhengzhuang/xfytd/
性感不快	zhengzhuang/xgbk/
性交困难	zhengzhuang/xjkn/
性交疼痛	zhengzhuang/xjtt/
性施虐癖	zhengzhuang/xsnp/
性受虐癖	zhengzhuang/xsnp_5236/
性腺发育不良	zhengzhuang/xxfybl/
性心理不成熟	zhengzhuang/xxlbcs/
性兴趣减退感	zhengzhuang/xxqjtg/
性欲减退	zhengzhuang/xyjt/
性欲亢进	zhengzhuang/xykj/
性早熟	zhengzhuang/xzs/
性窒息	zhengzhuang/xzx/
胸壁浸润	zhengzhuang/xbjr/
胸壁塌陷	zhengzhuang/xbtx/
胸壁疼痛	zhengzhuang/xbtt/
胸壁血管充盈	zhengzhuang/xbxgcy/
胸部长痘	zhengzhuang/xbcd_5248/
胸部沉重感	zhengzhuang/xbczg/
胸部挫伤	zhengzhuang/xbcs/
胸部大片斑块	zhengzhuang/xbdpbk/
胸部紧迫或束带感	zhengzhuang/xbjphsdg/
胸部下垂	zhengzhuang/xbxc/
胸部隐痛	zhengzhuang/xbyt/
胸部有过度回响	zhengzhuang/xbygdhx/
胸大肌痛	zhengzhuang/xdjt/
胸大肌外侧缘处如花生米大小的肿块	zhengzhuang/xdjwcycrhsmdxdzk/
胸腹壁浅在条索伴疼痛或牵扯痛	zhengzhuang/xfbqztsbtthqct/
胸腹部畸形	zhengzhuang/xfbjx/
胸腹呈矛盾运动	zhengzhuang/xfcmdyd/
胸膈间烧灼嘈杂感	zhengzhuang/xgjszczg/
胸骨后烧灼样痛	zhengzhuang/xghszyt/
胸骨后疼痛	zhengzhuang/xghtt/
胸骨后异物阻塞感及隐痛	zhengzhuang/xghywzsgjyt/
胸骨裂	zhengzhuang/xgl/
胸骨隆凸	zhengzhuang/xglt/
胸骨下端压痛	zhengzhuang/xgxdyt/
胸骨压痛	zhengzhuang/xgyt/
胸肌萎缩	zhengzhuang/xjws/
胸降主动脉严重狭窄	zhengzhuang/xjzdmyzxz/
胸口紧绷	zhengzhuang/xkjb/
胸口闪电疼痛	zhengzhuang/xksdtt/
胸廓畸形	zhengzhuang/xkjx/
胸廓塌陷畸形	zhengzhuang/xktxjx/
胸廓狭窄而扁	zhengzhuang/xkxzeb/
胸廓异常	zhengzhuang/xkyc/
胸闷	zhengzhuang/xm_5277/
胸闷憋气	zhengzhuang/xmbq/
胸膜肥厚	zhengzhuang/xmfh/
胸膜钙化	zhengzhuang/xmgh/
胸膜毛细血管通透性增加	zhengzhuang/xmmxxgttxzj/
胸膜摩擦音	zhengzhuang/xmmcy/
胸膜休克	zhengzhuang/xmxk/
胸膜增厚	zhengzhuang/xmzh/
胸膜增厚粘连	zhengzhuang/xmzhzl/
胸膜粘连	zhengzhuang/xmzl/
胸膜转移	zhengzhuang/xmzy/
胸片示肺内孤立结节	zhengzhuang/xpsfngljj/
胸腔出口综合征	zhengzhuang/xqckzhz/
胸腔积液	zhengzhuang/xqjy/
胸式呼吸	zhengzhuang/xshx/
胸水	zhengzhuang/xs_5292/
胸锁乳突肌附着处压痛	zhengzhuang/xsrtjfzcyt/
胸痛	zhengzhuang/xt_5294/
胸痛伴呼吸困难	zhengzhuang/xtbhxkn/
胸痛伴冷汗	zhengzhuang/xtblh/
胸痛伴胸闷、心悸	zhengzhuang/xtbxm_xj/
胸腺高度萎缩	zhengzhuang/xxgdws/
胸腺缺如	zhengzhuang/xxqr/
胸腰段背部或臀部的疼痛	zhengzhuang/xydbbhtbdtt/
胸腰驼背	zhengzhuang/xytb/
胸腰椎损伤	zhengzhuang/xyzss/
胸腰椎压缩性骨折	zhengzhuang/xyzysxgz/
胸椎侧弯	zhengzhuang/xzcw/
胸椎畸形	zhengzhuang/xzjx_5305/
胸椎疼痛	zhengzhuang/xztt/
胸椎腰化	zhengzhuang/xzyh/
雄激素过多	zhengzhuang/xjsgd/
雄激素过少	zhengzhuang/xjsgs/
雄激素依赖	zhengzhuang/xjsyl/
熊猫眼	zhengzhuang/xmy_5311/
休克	zhengzhuang/xk/
休克较久后的肺部病变	zhengzhuang/xkjjhdfbbb/
休克性神经受累	zhengzhuang/xkxsjsl/
溴磺酞排泄延迟	zhengzhuang/xhtpxyc/
溴疹	zhengzhuang/xz/
虚汗	zhengzhuang/xh_5317/
虚火	zhengzhuang/xh_5318/
虚脉	zhengzhuang/xm_5319/
虚热口臭	zhengzhuang/xrkc/
虚脱	zhengzhuang/xt_5321/
嗅觉倒错	zhengzhuang/xjdc/
嗅觉过敏	zhengzhuang/xjgm/
嗅觉丧失	zhengzhuang/xjss/
嗅觉障碍	zhengzhuang/xjza/
悬垂型心脏	zhengzhuang/xcxxz/
悬雍垂松弛细长	zhengzhuang/xycscxc/
旋转性眩晕	zhengzhuang/xzxxy/
选择性缄默症	zhengzhuang/xzxjmz/
眩晕	zhengzhuang/xy/
学习困难	zhengzhuang/xxkn/
学习障碍	zhengzhuang/xxza/
血沉增快	zhengzhuang/xczk/
血沉增速	zhengzhuang/xczs/
血道播散	zhengzhuang/xdbs/
血睾酮降低	zhengzhuang/xgtjd/
血骨髓或痰涂片找到疟原虫	zhengzhuang/xgshttpzdnyc/
血管壁变薄	zhengzhuang/xgbbb/
血管壁及周围有Ig及补体沉着	zhengzhuang/xgbjzwyigjbtcz/
血管搏动或波形的改变	zhengzhuang/xgbdhbxdgb/
血管过敏性炎症	zhengzhuang/xggmxyz/
血管畸形	zhengzhuang/xgjx/
血管迷走性晕厥	zhengzhuang/xgmzxyj/
血管内凝血	zhengzhuang/xgnnx/
血管伤	zhengzhuang/xgs/
血管神经性水肿	zhengzhuang/xgsjxsz/
血管舒张性虚脱	zhengzhuang/xgszxxt/
血管萎缩性白斑	zhengzhuang/xgwsxbb/
血管性痴呆	zhengzhuang/xgxcd/
血管性水肿	zhengzhuang/xgxsz/
血管性头痛	zhengzhuang/xgxtt/
血管炎	zhengzhuang/xgy/
血管硬化	zhengzhuang/xgyh/
血管杂音	zhengzhuang/xgzy/
血管增生	zhengzhuang/xgzs_5355/
血管痣	zhengzhuang/xgz/
血红蛋白尿	zhengzhuang/xhdbn/
血痂	zhengzhuang/xj_5358/
血浆白蛋白降低	zhengzhuang/xjbdbjd/
血浆胆固醇水平高	zhengzhuang/xjdgcspg/
血精	zhengzhuang/xj_5361/
血离脉络	zhengzhuang/xlml/
血流不畅	zhengzhuang/xlbc/
血流动力学障碍	zhengzhuang/xldlxza/
血流阻力增加	zhengzhuang/xlzlzj/
血脑屏障通透性高	zhengzhuang/xnpzttxg/
血尿	zhengzhuang/xn/
血尿伴蛋白尿	zhengzhuang/xnbdbn/
血尿伴排尿不畅	zhengzhuang/xnbpnbc/
血疱	zhengzhuang/xp/
血偏酸	zhengzhuang/xps/
血清HDL-C水平减低	zhengzhuang/xqhdl_cspjd/
血清TG水平升高	zhengzhuang/xqtgspsg/
血清睾酮浓度低下	zhengzhuang/xqgtnddx/
血清睾酮浓度明显升高	zhengzhuang/xqgtndmxsg/
血清甲胎蛋白升高	zhengzhuang/xqjtdbsg/
血清碱性磷酸酶活性增高	zhengzhuang/xqjxlsmhxzg/
血清碱性磷酸酶可呈进行性增高	zhengzhuang/xqjxlsmkcjxxzg/
血清降钙素水平增高	zhengzhuang/xqjgsspzg/
血清抗GBM抗体阳性	zhengzhuang/xqkgbmktyx/
血清酶学改变	zhengzhuang/xqmxgb/
血清免疫球蛋白可升高	zhengzhuang/xqmyqdbksg/
血清钠增高	zhengzhuang/xqnzg/
血清铜氧化酶吸光度降低	zhengzhuang/xqtyhmxgdjd/
血清中高水平的谷草转氨酶(AST)	zhengzhuang/xqzgspdgczam_ast_/
血缺氧	zhengzhuang/xqy/
血热	zhengzhuang/xr_5387/
血栓后综合征	zhengzhuang/xshzhz/
血栓肌化	zhengzhuang/xsjh/
血栓扩展	zhengzhuang/xskz/
血栓脱落	zhengzhuang/xstl/
血栓外痔	zhengzhuang/xswz/
血栓性赘生物	zhengzhuang/xsxzsw/
血丝痰	zhengzhuang/xst/
血糖升高	zhengzhuang/xtsg/
血糖值升高	zhengzhuang/xtzsg/
血吸虫导致的肝硬化	zhengzhuang/xxcdzdgyh/
血象异常	zhengzhuang/xxyc/
血小板减少	zhengzhuang/xxbjs/
血小板减少性紫癜	zhengzhuang/xxbjsxzd/
血小板聚集增强	zhengzhuang/xxbjjzq/
血小板寿命缩短	zhengzhuang/xxbsmsd/
血小板增多	zhengzhuang/xxbzd/
血性恶露	zhengzhuang/xxel/
血性恶露持续时间延长	zhengzhuang/xxelcxsjyc/
血性耳分泌物	zhengzhuang/xxefmw/
血性耳漏	zhengzhuang/xxel_5407/
血性腹水	zhengzhuang/xxfs/
血性渗液	zhengzhuang/xxsy/
血性胸水	zhengzhuang/xxxs/
血胸	zhengzhuang/xx/
血虚	zhengzhuang/xx_5412/
血压波动大	zhengzhuang/xybdd/
血压偏低	zhengzhuang/xypd/
血压为零	zhengzhuang/xywl/
血压下降	zhengzhuang/xyxj/
血液呈现浓缩	zhengzhuang/xycxns/
血液改变	zhengzhuang/xygb/
血液粘度增高	zhengzhuang/xyzdzg/
血液粘滞度增高	zhengzhuang/xyzzdzg/
血瘀体质	zhengzhuang/xytz/
血运障碍	zhengzhuang/xyza/
血脂异常	zhengzhuang/xzyc/
血中钙离子过高	zhengzhuang/xzglzgg/
血肿形成	zhengzhuang/xzxc/
循环衰竭	zhengzhuang/xhsj/
一侧胸廓塌陷	zhengzhuang/ycxktx/
“鸭步”步态	zhengzhuang/_yb_bt/
“猿手”畸形	zhengzhuang/_ys_jx/
Y-现象和菱形现象	zhengzhuang/y_xxhlxxx/
匙状指（趾）	zhengzhuang/czz_z__5431/
烦渴多饮	zhengzhuang/fkdy/
剧烈运动后哮喘	zhengzhuang/jlydhxc/
前胸压迫性疼痛	zhengzhuang/qxypxtt/
乳糜泻	zhengzhuang/rmx_5435/
吮乳困难	zhengzhuang/srkn/
涎瘘	zhengzhuang/xl/
胸段或腰段脊髓伤	zhengzhuang/xdhydjss/
胸腰段及腰椎前凸消失	zhengzhuang/xydjyzqtxs/
压力和体位性多汗	zhengzhuang/ylhtwxdh/
压迫瘘口试验	zhengzhuang/yplksy/
压缩型骨折	zhengzhuang/ysxgz/
牙槽突型	zhengzhuang/yctx/
牙齿呈黄色浅灰色或深灰色	zhengzhuang/ycchsqhshshs/
牙齿呈棕黑色	zhengzhuang/ycczhs/
牙齿臭	zhengzhuang/ycc/
牙齿发黄	zhengzhuang/ycfh/
牙齿缝隙大	zhengzhuang/ycfxd/
牙齿黑斑	zhengzhuang/ychb/
牙齿较小呈半透明状	zhengzhuang/ycjxcbtmz/
牙齿结构异常	zhengzhuang/ycjgyc/
牙齿颈部黄斑	zhengzhuang/ycjbhb/
牙齿萌出疼痛	zhengzhuang/ycmctt/
牙齿萌出异常	zhengzhuang/ycmcyc/
牙齿上白垩色到褐色的斑块	zhengzhuang/ycsbesdhsdbk/
牙齿数目不足	zhengzhuang/ycsmbz/
牙齿数目过剩	zhengzhuang/ycsmgs/
牙齿松动和脱落	zhengzhuang/ycsdhtl/
牙齿小而稀疏	zhengzhuang/ycxexs/
牙齿小且无光泽	zhengzhuang/ycxqwgz/
牙齿形态异常	zhengzhuang/ycxtyc/
牙齿颜色异常	zhengzhuang/ycysyc/
牙齿咬合无力	zhengzhuang/ycyhwl/
牙齿异常	zhengzhuang/ycyc/
牙齿拥挤错位排列不齐	zhengzhuang/ycyjcwplbq/
牙齿遇冷热痛	zhengzhuang/ycylrt/
牙的咀嚼磨损	zhengzhuang/ydjjms/
牙缝增宽	zhengzhuang/yfzk/
牙根外露	zhengzhuang/ygwl/
牙关紧闭	zhengzhuang/ygjb/
牙冠呈半透明乳光色	zhengzhuang/ygcbtmrgs/
牙列稀疏	zhengzhuang/ylxs/
牙列拥挤	zhengzhuang/ylyj/
牙疼	zhengzhuang/yt/
牙体损伤	zhengzhuang/ytss/
牙痛	zhengzhuang/yt_5476/
牙脱位	zhengzhuang/ytw/
牙移位	zhengzhuang/yyw/
牙龈出血	zhengzhuang/yycx/
牙龈上发生黑线	zhengzhuang/yysfshx/
牙龈深红或暗红色	zhengzhuang/yyshhahs/
牙龈痛	zhengzhuang/yyt/
牙龈萎缩	zhengzhuang/yyws/
牙龈痒胀	zhengzhuang/yyyz/
牙龈肿胀	zhengzhuang/yyzz/
牙有伸长感及触痛	zhengzhuang/yyscgjct/
牙釉质腐蚀	zhengzhuang/yyzfs/
牙周袋形成	zhengzhuang/yzdxc/
疋氏（Pickweckian）综合征	zhengzhuang/ys_pickweckian_zhz/
咽部充血	zhengzhuang/ybcx/
咽部和喉部危象	zhengzhuang/ybhhbwx/
咽部肌肉运动障碍	zhengzhuang/ybjrydza/
咽部溃疡	zhengzhuang/ybky/
咽部慢性充血	zhengzhuang/ybmxcx/
咽部苹果酱样结节	zhengzhuang/ybpgjyjj/
咽部异物感	zhengzhuang/ybywg/
咽部有散在灰白色丘疱疹	zhengzhuang/ybyszhbsqpz/
咽部有异物感	zhengzhuang/ybyywg/
咽部粘膜弥漫充血	zhengzhuang/ybzmmmcx/
咽部灼热疼痛	zhengzhuang/ybzrtt/
咽反射	zhengzhuang/yfs/
咽反射亢进	zhengzhuang/yfskj/
咽反射消失	zhengzhuang/yfsxs/
咽鼓管堵塞	zhengzhuang/yggds/
咽喉部充血	zhengzhuang/yhbcx/
咽喉部干燥刺痒	zhengzhuang/yhbgzcy/
咽喉干燥充血	zhengzhuang/yhgzcx/
咽喉干燥及灼热感	zhengzhuang/yhgzjzrg/
咽喉及口内刺痒	zhengzhuang/yhjkncy/
咽喉疼痛	zhengzhuang/yhtt/
咽喉炎	zhengzhuang/yhy/
咽颊部烧伤	zhengzhuang/yjbss/
咽痛	zhengzhuang/yt_5513/
咽炎、舌炎、龈炎	zhengzhuang/yy_sy_yy/
咽异感症	zhengzhuang/yygz/
烟酸缺乏	zhengzhuang/ysqf/
延髓出血	zhengzhuang/yscx/
延髓性麻痹	zhengzhuang/ysxmb/
严重腹腔感染	zhengzhuang/yzfqgr/
严重急性呼吸道症	zhengzhuang/yzjxhxdz/
严重情绪障碍	zhengzhuang/yzqxza/
严重性假肥大型营养不良症	zhengzhuang/yzxjfdxyyblz/
言语凌乱	zhengzhuang/yyll/
言语紊乱	zhengzhuang/yywl/
言语增多	zhengzhuang/yyzd/
言语中断	zhengzhuang/yyzd_5526/
言语自动症	zhengzhuang/yyzdz/
炎性损害	zhengzhuang/yxsh/
炎性外痔	zhengzhuang/yxwz/
炎性细胞浸润	zhengzhuang/yxxbjr/
盐类皮质激素分泌过多	zhengzhuang/ylpzjsfmgd/
盐类皮质激素分泌过少	zhengzhuang/ylpzjsfmgs/
颜面潮红	zhengzhuang/ymch/
颜面充血呈樱桃红色	zhengzhuang/ymcxcyths/
颜面的火焰状母斑	zhengzhuang/ymdhyzmb/
颜面发红紫色	zhengzhuang/ymfhzs/
颜面受累时褶皱加深形成“狮面”	zhengzhuang/ymslszzjsxc_sm_/
眼白出现红点	zhengzhuang/ybcxhd/
眼白发红	zhengzhuang/ybfh/
眼白发黄	zhengzhuang/ybfh_5540/
眼白过白	zhengzhuang/ybgb/
眼白蓝灰色或黑色斑点	zhengzhuang/yblhshhsbd/
眼部感染	zhengzhuang/ybgr/
眼部烧伤感	zhengzhuang/ybssg/
眼部胀痛	zhengzhuang/ybzt/
眼充血	zhengzhuang/ycx/
眼底出血和渗出	zhengzhuang/ydcxhsc/
眼底点状或火焰状出血	zhengzhuang/yddzhhyzcx/
眼底发现黄斑呈带灰色变色	zhengzhuang/ydfxhbcdhsbs/
眼底改变	zhengzhuang/ydgb/
眼底黄斑部的樱桃红斑点	zhengzhuang/ydhbbdythbd/
眼底无红光反射	zhengzhuang/ydwhgfs/
眼底异常	zhengzhuang/ydyc/
眼底樱桃红斑	zhengzhuang/ydythb/
眼发胀、发干	zhengzhuang/yfz_fg/
眼干	zhengzhuang/yg/
眼干涩酸胀，易疲劳	zhengzhuang/ygssz_ypl/
眼花	zhengzhuang/yh/
眼肌麻痹	zhengzhuang/yjmb/
眼肌瘫痪	zhengzhuang/yjth/
眼睑闭合不全	zhengzhuang/yjbhbq/
眼睑部有明显的刺痒感和烧灼感	zhengzhuang/yjbymxdcyghszg/
眼睑呈紫红色	zhengzhuang/yjczhs/
眼睑肥厚	zhengzhuang/yjfh/
眼睑浮肿	zhengzhuang/yjfz/
眼睑畸形	zhengzhuang/yjjx/
眼睑痉挛	zhengzhuang/yjjl/
眼睑脓肿	zhengzhuang/yjnz/
眼睑松弛	zhengzhuang/yjsc/
眼睑松弛和上唇增厚	zhengzhuang/yjschsczh/
眼睑外翻	zhengzhuang/yjwf/
眼睑下垂	zhengzhuang/yjxc/
眼睑异物	zhengzhuang/yjyw/
眼睑震颤	zhengzhuang/yjzc/
眼睑肿胀且呈淡绿色	zhengzhuang/yjzzqcdls/
眼角长斑	zhengzhuang/yjcb/
眼角膜反射消失	zhengzhuang/yjmfsxs/
眼结膜黑变	zhengzhuang/yjmhb/
眼结膜上出现瘀点	zhengzhuang/yjmscxyd/
眼结膜水肿及角膜溃疡	zhengzhuang/yjmszjjmky/
眼晶体前房棕色光反射	zhengzhuang/yjtqfzsgfs/
眼睛刺痛	zhengzhuang/yjct/
眼睛发红	zhengzhuang/yjfh_5583/
眼睛痒	zhengzhuang/yjy/
眼距宽阔	zhengzhuang/yjkk/
眼眶内持续性、针刺或撕扯样痛	zhengzhuang/ykncxx_zchscyt/
眼眶缩小	zhengzhuang/yksx/
眼眶疼痛	zhengzhuang/yktt/
眼眶异物	zhengzhuang/ykyw/
眼裂歪斜	zhengzhuang/ylwx/
眼裂细小	zhengzhuang/ylxx/
眼面痛	zhengzhuang/ymt/
眼内有异物感	zhengzhuang/ynyywg/
眼皮跳	zhengzhuang/ypt/
眼皮下垂	zhengzhuang/ypxc/
眼疲劳	zhengzhuang/ypl/
眼前发黑	zhengzhuang/yqfh/
眼前黑影	zhengzhuang/yqhy/
眼前冒火花或眼前闪光	zhengzhuang/yqmhhhyqsg/
眼前冒金花	zhengzhuang/yqmjh/
眼前冒紫烟	zhengzhuang/yqmzy/
眼前异常闪光，增加的黑点	zhengzhuang/yqycsg_zjdhd/
眼球斑点	zhengzhuang/yqbd/
眼球不能随意动	zhengzhuang/yqbnsyd/
眼球不同轴	zhengzhuang/yqbtz/
眼球穿孔	zhengzhuang/yqck/
眼球垂直运动障碍	zhengzhuang/yqczydza/
眼球挫伤	zhengzhuang/yqcs/
眼球调节功能减退或消失	zhengzhuang/yqdjgnjthxs/
眼球浮动现象	zhengzhuang/yqfdxx/
眼球会聚功能麻痹或痉挛	zhengzhuang/yqhjgnmbhjl/
眼球内积脓而失明	zhengzhuang/yqnjnesm/
眼球内陷	zhengzhuang/yqnx/
眼球内斜	zhengzhuang/yqnx_5614/
眼球偏斜	zhengzhuang/yqpx/
眼球上翻并固定	zhengzhuang/yqsfbgd/
眼球突出	zhengzhuang/yqtc/
眼球压痛	zhengzhuang/yqyt/
眼球移位	zhengzhuang/yqyw/
眼球运动偏斜扭转	zhengzhuang/yqydpxnz/
眼球震颤	zhengzhuang/yqzc/
眼缺陷	zhengzhuang/yqx/
眼色素膜炎	zhengzhuang/yssmy/
眼神异常	zhengzhuang/ysyc/
眼屎多	zhengzhuang/ysd/
眼痛	zhengzhuang/yt_5626/
眼-头反射消失	zhengzhuang/y_tfsxs/
眼外肌运动无力	zhengzhuang/ywjydwl/
眼外转移	zhengzhuang/ywzy/
眼旋转	zhengzhuang/yxz/
眼压升高	zhengzhuang/yysg/
眼压突然迅速升高	zhengzhuang/yytrxssg/
眼张不开	zhengzhuang/yzbk/
眼胀	zhengzhuang/yz/
眼嘴的细小皱纹	zhengzhuang/yzdxxzw/
厌奶	zhengzhuang/yn/
厌食	zhengzhuang/ys/
羊膜腔感染	zhengzhuang/ymqgr/
羊水粪染	zhengzhuang/ysfr/
羊水过多	zhengzhuang/ysgd/
羊水血性	zhengzhuang/ysxx/
羊水中回声增强增多	zhengzhuang/yszhszqzd/
羊水中有胎粪	zhengzhuang/yszytf/
阳盛体质	zhengzhuang/ystz/
阳虚体质	zhengzhuang/yxtz/
阳虚胃痛	zhengzhuang/yxwt/
杨梅样舌	zhengzhuang/ymys/
仰颈时吞咽困难	zhengzhuang/yjstykn/
仰卧呼吸	zhengzhuang/ywhx/
仰趾外翻	zhengzhuang/yzwf/
氧分压低	zhengzhuang/yfyd/
腰背部窦道	zhengzhuang/ybbdd/
腰背部有皮毛窦	zhengzhuang/ybbypmd/
腰背刺痛	zhengzhuang/ybct/
腰背的持续隐痛	zhengzhuang/ybdcxyt/
腰背酸痛	zhengzhuang/ybst/
腰背痛	zhengzhuang/ybt/
腰部包块	zhengzhuang/ybbk/
腰部的不稳交锁现象	zhengzhuang/ybdbwjsxx/
腰部钝痛	zhengzhuang/ybdt/
腰部缓慢增大的软肿块	zhengzhuang/ybhmzddrzk/
腰部僵硬及腰前凸消失	zhengzhuang/ybjyjyqtxs/
腰部僵直感	zhengzhuang/ybjzg/
腰部酸胀及无力	zhengzhuang/ybszjwl/
腰长骨刺	zhengzhuang/ycgc/
腰大肌痉挛	zhengzhuang/ydjjl/
腰大肌脓肿	zhengzhuang/ydjnz/
腰大肌阴影消失	zhengzhuang/ydjyyxs/
腰大肌肿胀	zhengzhuang/ydjzz/
腰骶部或下腰部疼痛	zhengzhuang/ydbhxybtt/
腰骶部皮肤多毛、异常色素沉着	zhengzhuang/ydbpfdm_ycsscz/
腰骶部酸痛	zhengzhuang/ydbst/
腰骶疼痛	zhengzhuang/ydtt/
腰肌痉挛	zhengzhuang/yjjl_5674/
腰脊椎疼痛	zhengzhuang/yjztt/
腰软不能直起	zhengzhuang/yrbnzq/
腰酸	zhengzhuang/ys_5677/
腰酸背痛	zhengzhuang/ysbt/
腰痛伴尿频、尿急、尿痛	zhengzhuang/ytbnp_nj_nt/
腰痛伴肾区叩击痛	zhengzhuang/ytbsqkjt/
腰痛卧床加重	zhengzhuang/ytwcjz/
腰臀部广泛性疼痛并向下放射	zhengzhuang/ytbgfxttbxxfs/
腰膝酸软	zhengzhuang/yxsr/
腰椎不稳	zhengzhuang/yzbw/
腰椎骶化	zhengzhuang/yzdh/
腰椎肥大	zhengzhuang/yzfd/
腰椎间盘突出	zhengzhuang/yzjptc/
腰椎膨出	zhengzhuang/yzpc/
腰椎退化	zhengzhuang/yzth/
腰椎椎管狭窄	zhengzhuang/yzzgxz/
摇摆步态	zhengzhuang/ybbt/
摇头转颈	zhengzhuang/ytzj/
咬合关系错乱	zhengzhuang/yhgxcl/
咬伤愈合的伤口出现痛痒或麻木	zhengzhuang/ysyhdskcxtyhmm/
咬痛	zhengzhuang/yt_5695/
咬指甲	zhengzhuang/yzj/
咬嘴唇或舌	zhengzhuang/yzchs/
药物过敏反应	zhengzhuang/ywgmfy/
药物性肥胖	zhengzhuang/ywxfp/
药物性水肿	zhengzhuang/ywxsz/
药物依赖	zhengzhuang/ywyl/
药物中毒	zhengzhuang/ywzd/
药疹	zhengzhuang/yz_5703/
耀光感	zhengzhuang/ygg/
噎痛感	zhengzhuang/ytg/
叶间裂常呈弧形下坠	zhengzhuang/yjlcchxxz/
叶间裂移位	zhengzhuang/yjlyw/
叶状脱色斑	zhengzhuang/yztsb/
夜间盗汗	zhengzhuang/yjdh/
夜间肩痛	zhengzhuang/yjjt/
夜间磨牙	zhengzhuang/yjmy/
夜间睡眠气短憋醒	zhengzhuang/yjsmqdbx/
夜间头痛	zhengzhuang/yjtt/
夜惊	zhengzhuang/yj/
夜盲	zhengzhuang/ym/
夜尿增多	zhengzhuang/ynzd/
夜游症	zhengzhuang/yyz/
液气胸	zhengzhuang/yqx_5718/
液体平衡失调	zhengzhuang/ytphsd/
腋部掌心出汗	zhengzhuang/ybzxch/
腋部肿块	zhengzhuang/ybzk/
腋毛变稀少	zhengzhuang/ymbxs/
腋毛和阴毛脱落	zhengzhuang/ymhymtl/
腋毛毛干上有微小结节	zhengzhuang/ymmgsywxjj/
腋区疼痛	zhengzhuang/yqtt/
腋窝多汗	zhengzhuang/ywdh/
腋窝痛	zhengzhuang/ywt/
腋窝有异味	zhengzhuang/ywyyw/
腋下淋巴肿大	zhengzhuang/yxlbzd/
一侧乳头萎缩，另侧水肿	zhengzhuang/ycrtws_lcsz/
一侧下腹坠痛	zhengzhuang/ycxfzt/
一侧性下腹剧烈疼痛	zhengzhuang/ycxxfjltt/
一侧颜面肥大	zhengzhuang/ycymfd/
一侧腰腹突发“刀割”样绞痛	zhengzhuang/ycyftf_dg_yjt/
一侧阴囊内逐渐增大的无痛性肿块	zhengzhuang/ycynnzjzddwtxzk/
一过性的流感样症状	zhengzhuang/ygxdlgyzz/
一过性红斑狼疮样	zhengzhuang/ygxhblcy/
一过性昏厥	zhengzhuang/ygxhj/
一过性脑缺血	zhengzhuang/ygxnqx/
一过性尿蛋白	zhengzhuang/ygxndb/
一过性全面性遗忘	zhengzhuang/ygxqmxyw/
一过性肉眼血尿	zhengzhuang/ygxryxn/
一过性心尖部收缩期杂音	zhengzhuang/ygxxjbssqzy/
一过性意识蒙眬	zhengzhuang/ygxysml/
一咳嗽胸口就疼	zhengzhuang/yksxkjt/
一时性便秘	zhengzhuang/ysxbm/
一氧化碳中毒	zhengzhuang/yyhtzd/
依赖公式化	zhengzhuang/ylgsh/
依赖症	zhengzhuang/ylz/
胰岛细胞破坏	zhengzhuang/ydxbph/
胰酶分泌或排出量降低	zhengzhuang/ymfmhpcljd/
胰石阻塞	zhengzhuang/yszs/
胰腺功能不足	zhengzhuang/yxgnbz/
胰腺内钙化	zhengzhuang/yxngh/
胰腺外分泌功能不良	zhengzhuang/yxwfmgnbl/
胰腺纤维化	zhengzhuang/yxxwh/
胰源性腹痛	zhengzhuang/yyxft/
移动性浊音	zhengzhuang/ydxzy/
移行病变	zhengzhuang/yxbb/
遗传性出血性毛细血管扩张症	zhengzhuang/ycxcxxmxxgkzz/
遗传性肥胖	zhengzhuang/ycxfp/
遗传性果糖不耐受	zhengzhuang/ycxgtbns/
遗精	zhengzhuang/yj_5763/
遗尿	zhengzhuang/yn_5764/
疑病症	zhengzhuang/ybz/
乙肝e抗体（抗HBe）阳性	zhengzhuang/ygekt_khbe_yx/
乙肝e抗原（HBeAg）阳性	zhengzhuang/ygeky_hbeag_yx/
乙肝表面抗体（抗HBs）阳性	zhengzhuang/ygbmkt_khbs_yx/
乙肝表面抗原（HBsAg）阳性	zhengzhuang/ygbmky_hbsag_yx/
以偷窥为快感源泉的性变态	zhengzhuang/ytkwkgyqdxbt/
以头昏为主的眩晕	zhengzhuang/ythwzdxy/
蚁走感	zhengzhuang/yzg/
异常矮小	zhengzhuang/ycax/
异常子宫出血	zhengzhuang/yczgcx/
异常粗大的舞蹈样动作	zhengzhuang/yccddwdydz/
异常高大	zhengzhuang/ycgd/
异常体位所致的窒息	zhengzhuang/yctwszdzx/
异常鱼鳞癣	zhengzhuang/ycylx/
异食癖	zhengzhuang/ysp/
异嗜酸癖	zhengzhuang/yssp/
异位钙化	zhengzhuang/ywgh/
异位妊娠	zhengzhuang/ywrs/
异位性心动过速	zhengzhuang/ywxxdgs/
异型网织细胞	zhengzhuang/yxwzxb/
异性蛋白反应	zhengzhuang/yxdbfy/
异性装扮癖	zhengzhuang/yxzbp/
异源性ACTH	zhengzhuang/yyxacth/
抑郁	zhengzhuang/yy/
抑郁性木僵	zhengzhuang/yyxmj/
抑郁症	zhengzhuang/yyz_5790/
易变性痉挛	zhengzhuang/ybxjl/
易跌倒	zhengzhuang/ydd/
易饿	zhengzhuang/ye/
易昏厥	zhengzhuang/yhj/
易激动	zhengzhuang/yjd/
易激惹	zhengzhuang/yjr/
易倦感	zhengzhuang/yjg/
易哭	zhengzhuang/yk/
易疲乏	zhengzhuang/ypf/
易醒	zhengzhuang/yx/
易性别癖	zhengzhuang/yxbp/
易于产生病理嫉妒信念	zhengzhuang/yycsbljdxn/
谊妄	zhengzhuang/yw/
逸搏出现	zhengzhuang/ybcx_5804/
意识短暂中断	zhengzhuang/ysdzzd/
意识改变状态	zhengzhuang/ysgbzt/
意识朦胧状态	zhengzhuang/ysmlzt/
意识模糊	zhengzhuang/ysmh/
意识丧失	zhengzhuang/ysss/
意识障碍	zhengzhuang/ysza/
意向倒错	zhengzhuang/yxdc/
意向性震颤	zhengzhuang/yxxzc/
意志丧失性格	zhengzhuang/yzssxg/
溢乳	zhengzhuang/yr/
癔症步态	zhengzhuang/yzbt/
阴部溃疡	zhengzhuang/ybky_5816/
阴部皮肤潮红	zhengzhuang/ybpfch/
阴唇融合	zhengzhuang/ycrh/
阴道闭锁	zhengzhuang/ydbs/
阴道不规则出血	zhengzhuang/ydbgzcx/
阴道持续流血不停	zhengzhuang/ydcxlxbt/
阴道持续少量流血	zhengzhuang/ydcxsllx/
阴道持续中量流血	zhengzhuang/ydcxzllx/
阴道出血	zhengzhuang/ydcx/
阴道分泌物增多	zhengzhuang/ydfmwzd/
阴道横隔	zhengzhuang/ydhg/
阴道后穹窿触痛	zhengzhuang/ydhqlct/
阴道口局部红肿热痛	zhengzhuang/ydkjbhzrt/
阴道裂伤	zhengzhuang/ydls/
阴道流出黄色或血性带臭味的分泌物	zhengzhuang/ydlchshxxdcwdfmw/
阴道流血过多	zhengzhuang/ydlxgd/
阴道内出现粪质和血性分泌	zhengzhuang/ydncxfzhxxfm/
阴道黏膜膨胀	zhengzhuang/ydnmpz/
阴道脓性分泌物	zhengzhuang/ydnxfmw/
阴道排出碎块组织	zhengzhuang/ydpcskzz/
阴道排液呈黑水样	zhengzhuang/ydpychsy/
阴道入口粘膜撕裂	zhengzhuang/ydrkzmsl/
阴道血性分泌物	zhengzhuang/ydxxfmw/
阴道粘连	zhengzhuang/ydzl/
阴道粘连甚至闭锁	zhengzhuang/ydzlszbs/
阴道转移	zhengzhuang/ydzy/
阴蒂肥大	zhengzhuang/ydfd/
阴茎表浅性溃疡	zhengzhuang/yjbqxky/
阴茎短	zhengzhuang/yjd_5844/
阴茎龟头橡皮肿	zhengzhuang/yjgtxpz/
阴茎和阴囊水肿	zhengzhuang/yjhynsz/
阴茎损伤	zhengzhuang/yjss/
阴茎疼痛	zhengzhuang/yjtt_5848/
阴茎样尿道	zhengzhuang/yjynd/
阴茎异常	zhengzhuang/yjyc/
阴茎硬结	zhengzhuang/yjyj/
阴毛脱落	zhengzhuang/ymtl/
阴毛早发育	zhengzhuang/ymzfy/
阴囊潮湿有异味	zhengzhuang/yncsyyw/
阴囊上有白色小疙瘩	zhengzhuang/ynsybsxgd/
阴囊舌	zhengzhuang/yns/
阴囊水肿	zhengzhuang/ynsz/
阴囊下坠	zhengzhuang/ynxz/
阴囊肿大	zhengzhuang/ynzd_5859/
阴囊肿胀	zhengzhuang/ynzz/
阴囊坠胀痛	zhengzhuang/ynzzt/
阴虚火亢症	zhengzhuang/yxhkz/
阴虚体质	zhengzhuang/yxtz_5863/
阴虚胃痛	zhengzhuang/yxwt_5864/
阴阳气血失衡	zhengzhuang/yyqxsh/
阴雨天颈肩背部酸痛	zhengzhuang/yytjjbbst/
音调韵律的异常	zhengzhuang/ydyldyc/
吟诗样语言	zhengzhuang/ysyyy/
饮酒性面红	zhengzhuang/yjxmh/
饮水呛咳	zhengzhuang/ysqk/
隐睾	zhengzhuang/yg_5871/
隐球菌感染	zhengzhuang/yqjgr/
隐球菌囊膜多糖堆积	zhengzhuang/yqjnmdtdj/
隐性产后出血	zhengzhuang/yxchcx/
隐性水肿	zhengzhuang/yxsz/
应激功能减退	zhengzhuang/yjgnjt/
婴儿步行晚	zhengzhuang/yebxw/
婴儿出牙延迟	zhengzhuang/yecyyc/
婴儿过胖	zhengzhuang/yegp/
婴儿含吮时乳头刀割样疼痛并渗血	zhengzhuang/yehssrtdgyttbsx/
婴儿褐色或暗绿色的粘液便	zhengzhuang/yehshalsdzyb/
婴儿黑头粉刺	zhengzhuang/yehtfc/
婴儿脊柱侧凸	zhengzhuang/yejzct/
婴儿痉挛症	zhengzhuang/yejlz/
婴儿肋骨外翻	zhengzhuang/yelgwf/
婴儿脸色发黄	zhengzhuang/yelsfh/
婴儿热痱	zhengzhuang/yerf/
婴儿湿疹	zhengzhuang/yesz/
婴儿湿疹结痂	zhengzhuang/yeszjj/
婴儿睡觉不踏实	zhengzhuang/yesjbts/
婴儿睡觉出汗	zhengzhuang/yesjch/
婴儿睡觉打鼾	zhengzhuang/yesjdh/
婴儿睡觉惊跳	zhengzhuang/yesjjt/
婴儿睡觉前哭闹	zhengzhuang/yesjqkn/
婴儿睡觉摇头	zhengzhuang/yesjyt/
婴儿睡眠少	zhengzhuang/yesms/
婴儿说话晚	zhengzhuang/yeshw/
婴儿体重增长过快	zhengzhuang/yetzzcgk/
婴儿头大	zhengzhuang/yetd/
婴儿头皮结血痂	zhengzhuang/yetpjxj/
婴儿头皮有黄色结痂	zhengzhuang/yetpyhsjj/
婴儿吐奶	zhengzhuang/yetn/
婴儿臀部红	zhengzhuang/yetbh/
婴儿喂养困难	zhengzhuang/yewykn/
婴儿厌食	zhengzhuang/yeys/
婴儿枕秃	zhengzhuang/yezt/
婴幼儿抽风	zhengzhuang/yyecf/
婴幼儿脐部有肿物突出	zhengzhuang/yyeqbyzwtc/
婴幼儿睡眠时经常翻动，反复摇头	zhengzhuang/yyesmsjcfd_ffyt/
婴幼儿外阴疼痛	zhengzhuang/yyewytt/
樱桃红掌色	zhengzhuang/ythzs/
鹰钩鼻	zhengzhuang/ygb/
迎风流泪	zhengzhuang/yfll/
营养不良	zhengzhuang/yybl/
营养不良性水肿	zhengzhuang/yyblxsz/
营养代谢缺乏	zhengzhuang/yydxqf/
营养性皮肤改变	zhengzhuang/yyxpfgb/
营养障碍	zhengzhuang/yyza/
硬斑	zhengzhuang/yb/
硬腭呈半圆形隆起	zhengzhuang/yecbyxlq/
硬化	zhengzhuang/yh_5921/
硬脊膜膨出	zhengzhuang/yjmpc/
硬下疳	zhengzhuang/yxg/
硬肿症	zhengzhuang/yzz/
拥抱反射减弱或消失	zhengzhuang/ybfsjrhxs/
拥抱反射消失	zhengzhuang/ybfsxs/
永久性秃发	zhengzhuang/yjxtf/
用口探索物体	zhengzhuang/yktswt/
用药过程中出现胃部症状	zhengzhuang/yygczcxwbzz/
忧郁	zhengzhuang/yy_5930/
幽门瘢痕性狭窄	zhengzhuang/ymbhxxz/
幽门管溃疡	zhengzhuang/ymgky/
幽门管狭窄	zhengzhuang/ymgxz/
幽门肌肥大	zhengzhuang/ymjfd/
幽门前区溃疡	zhengzhuang/ymqqky/
幽门狭窄	zhengzhuang/ymxz/
幽门肿块	zhengzhuang/ymzk/
油腻性鳞屑	zhengzhuang/ynxlx/
疣状增殖	zhengzhuang/yzzz/
游走肾	zhengzhuang/yzs/
有机磷中毒	zhengzhuang/yjlzd/
有排卵性功血	zhengzhuang/yplxgx/
有效血容量减少	zhengzhuang/yxxrljs/
右背部痛	zhengzhuang/ybbt_5944/
右边脸颊长痘	zhengzhuang/ybljcd/
右侧束支传导阻滞	zhengzhuang/ycszcdzz/
右上腹持续性剧痛并向右肩部放射	zhengzhuang/ysfcxxjtbxyjbfs/
右上腹痛	zhengzhuang/ysft/
右室肥厚	zhengzhuang/ysfh/
右下腹可触及柔软腊肠样肿块	zhengzhuang/yxfkcjrrlcyzk/
右下腹痛	zhengzhuang/yxft/
右下腹痛伴呕吐	zhengzhuang/yxftbot/
右下腹压痛	zhengzhuang/yxfyt/
右心功能不全	zhengzhuang/yxgnbq/
右心室流出道	zhengzhuang/yxslcd/
右心衰竭	zhengzhuang/yxsj/
右胸痛	zhengzhuang/yxt/
淤血性心衰	zhengzhuang/yxxxs/
瘀斑	zhengzhuang/yb_5959/
瘀斑性环	zhengzhuang/ybxh/
瘀血	zhengzhuang/yx_5961/
瘀血斑	zhengzhuang/yxb/
瘀血积聚	zhengzhuang/yxjj/
瘀血性痛经	zhengzhuang/yxxtj/
鱼鳞癣样红皮	zhengzhuang/ylxyhp/
愉快感缺乏	zhengzhuang/ykgqf/
愚型样睑裂歪曲	zhengzhuang/yxyjlwq/
与脉搏相一致的眼球跳动	zhengzhuang/ymbxyzdyqtd/
语言发育迟缓	zhengzhuang/yyfych/
语音震颤增强	zhengzhuang/yyzczq/
遇冷后排汗增多	zhengzhuang/ylhphzd/
原发性便秘	zhengzhuang/yfxbm/
原发性痛经	zhengzhuang/yfxtj/
原发灶不明的转移灶	zhengzhuang/yfzbmdzyz/
圆形或卵圆形丘疹或结节	zhengzhuang/yxhlyxqzhjj/
远端胃窦产生异位节律	zhengzhuang/ydwdcsywjl/
远视屈光度数增加	zhengzhuang/ysqgdszj/
月经发黑	zhengzhuang/yjfh_5978/
月经量多	zhengzhuang/yjld/
月经期长痘	zhengzhuang/yjqcd/
月经期间腰疼	zhengzhuang/yjqjyt/
月经前水肿	zhengzhuang/yjqsz/
月经时多时少且淋漓不断	zhengzhuang/yjsdssqllbd/
月经稀少	zhengzhuang/yjxs/
月经血块过多	zhengzhuang/yjxkgd/
月经周期改变	zhengzhuang/yjzqgb/
孕产妇腰痛	zhengzhuang/ycfyt/
孕妇背痛	zhengzhuang/yfbt/
孕妇耻骨痛	zhengzhuang/yfcgt/
孕妇肚子痒	zhengzhuang/yfdzy/
孕妇非妊娠原因的腹痛	zhengzhuang/yffrsyydft/
孕妇腹部硬块	zhengzhuang/yffbyk/
孕妇口苦	zhengzhuang/yfkk/
孕妇气喘	zhengzhuang/yfqc/
孕妇全身性水肿	zhengzhuang/yfqsxsz/
孕妇上火	zhengzhuang/yfsh/
孕妇腿抽筋	zhengzhuang/yftcj/
孕妇胃痛	zhengzhuang/yfwt/
孕妇小腹痛	zhengzhuang/yfxft/
孕妇小腿浮肿	zhengzhuang/yfxtfz/
孕妇小腿痒	zhengzhuang/yfxty/
孕妇胸闷气短	zhengzhuang/yfxmqd/
孕晚期腹痛	zhengzhuang/ywqft/
孕早期腹痛	zhengzhuang/yzqft/
孕中期腹痛	zhengzhuang/yzqft_6005/
运动不足综合征	zhengzhuang/ydbzzhz/
运动传导束受累	zhengzhuang/ydcdssl/
运动腹痛	zhengzhuang/ydft/
运动功能障碍	zhengzhuang/ydgnza/
运动后尿血	zhengzhuang/ydhnx/
运动后全身酸痛	zhengzhuang/ydhqsst/
运动或情绪激动诱发的胸痛	zhengzhuang/ydhqxjdyfdxt/
运动耐力降低	zhengzhuang/ydnljd/
运动气喘	zhengzhuang/ydqc/
运动失调	zhengzhuang/ydsd/
运动时膝前疼痛加剧	zhengzhuang/ydsxqttjj/
运动损伤	zhengzhuang/ydss/
运动性闭经	zhengzhuang/ydxbj/
运动性忽略症	zhengzhuang/ydxhlz/
运动性疲劳	zhengzhuang/ydxpl/
运动性失语	zhengzhuang/ydxsy/
运动性兴奋或抑制	zhengzhuang/ydxxfhyz/
晕车	zhengzhuang/yc/
晕动症	zhengzhuang/ydz/
晕机	zhengzhuang/yj_6025/
晕厥	zhengzhuang/yj_6026/
晕厥反复发作	zhengzhuang/yjfffz/
晕厥预兆	zhengzhuang/yjyz/
晕轮效应	zhengzhuang/ylxy/
晕眩	zhengzhuang/yx_6030/
晕血	zhengzhuang/yx_6031/
晕针	zhengzhuang/yz_6032/
糙皮病样皮疹	zhengzhuang/cpbypz/
侧腹壁或后腰部有压痛	zhengzhuang/cfbhhybyyt/
瘤块压迫	zhengzhuang/lkyp/
灾难反应	zhengzhuang/znfy/
脏腑功能失调	zhengzhuang/zfgnsd/
脏器变小	zhengzhuang/zqbx/
早饱	zhengzhuang/zb/
早搏	zhengzhuang/zb_6040/
早晨上下眼睑粘连	zhengzhuang/zcsxyjzl/
早孕反应重	zhengzhuang/zyfyz/
燥狂相	zhengzhuang/zkx/
躁狂	zhengzhuang/zk/
躁郁样	zhengzhuang/zyy/
增生性瘢痕	zhengzhuang/zsxbh/
增生性骨膜炎	zhengzhuang/zsxgmy/
增殖体肥大	zhengzhuang/zztfd/
增殖腺肥大	zhengzhuang/zzxfd/
眨眼不止	zhengzhuang/zybz/
谵妄	zhengzhuang/zw/
辗转体位	zhengzhuang/zztw/
张口呼吸	zhengzhuang/zkhx/
张口困难	zhengzhuang/zkkn/
张力性气胸	zhengzhuang/zlxqx/
张嘴颌骨响	zhengzhuang/zzhgx/
掌骨和跖骨短	zhengzhuang/zghzgd/
掌骨指数及指骨指数均增大	zhengzhuang/zgzsjzgzsjzd/
掌颏反射	zhengzhuang/zkfs/
掌纹atd角大于45°	zhengzhuang/zwatdjdy45/
掌心凹消失或稍隆起	zhengzhuang/zxaxshslq/
掌跖多汗	zhengzhuang/zzdh/
掌跖发红	zhengzhuang/zzfh/
掌跖角化过度	zhengzhuang/zzjhgd/
掌趾皮肤黄色角化物	zhengzhuang/zzpfhsjhw/
胀感	zhengzhuang/zg/
胀痛	zhengzhuang/zt_6067/
胀坠感	zhengzhuang/zzg/
招风耳	zhengzhuang/zfe/
折刀现象	zhengzhuang/zdxx/
蔗糖-异麦芽糖吸收不良	zhengzhuang/zt_ymytxsbl/
珍珠丘疹	zhengzhuang/zzqz/
真菌感染	zhengzhuang/zjgr/
真皮侵袭性生长	zhengzhuang/zpqxxsc/
真性菌尿	zhengzhuang/zxjn/
诊断室中所测血压始终增高	zhengzhuang/zdszscxyszzg/
枕部和颈后疼痛	zhengzhuang/zbhjhtt/
枕部疼痛	zhengzhuang/zbtt/
枕大神经痛	zhengzhuang/zdsjt/
枕横位入盆	zhengzhuang/zhwrp/
枕叶受损	zhengzhuang/zyss/
阵发性鼻塞	zhengzhuang/zfxbs/
阵发性肠绞痛	zhengzhuang/zfxcjt/
阵发性痴笑	zhengzhuang/zfxcx/
阵发性腹痛	zhengzhuang/zfxft/
阵发性或强直性惊厥	zhengzhuang/zfxhqzxjj/
阵发性狂笑	zhengzhuang/zfxkx/
阵发性夜间呼吸困难	zhengzhuang/zfxyjhxkn/
阵发性子宫收缩	zhengzhuang/zfxzgss/
阵挛	zhengzhuang/zl/
阵挛-强直型	zhengzhuang/zl_qzx/
镇静、麻醉剂所致昏迷	zhengzhuang/zj_mzjszhm/
镇静药中毒	zhengzhuang/zjyzd/
震颤	zhengzhuang/zc/
震颤性肌强直，运动徐缓	zhengzhuang/zcxjqz_ydxh/
震荡性神经受累	zhengzhuang/zdxsjsl/
震水音	zhengzhuang/zsy/
睁眼昏迷	zhengzhuang/zyhm/
正常免疫球蛋白减少	zhengzhuang/zcmyqdbjs/
正弦胎心率	zhengzhuang/zxtxl/
支气管肺泡音	zhengzhuang/zqgfpy/
支气管分泌物增加	zhengzhuang/zqgfmwzj/
支气管痉挛	zhengzhuang/zqgjl/
支气管脓性分泌物增多	zhengzhuang/zqgnxfmwzd/
支气管平滑肌痉挛	zhengzhuang/zqgphjjl/
支气管树受压	zhengzhuang/zqgssy/
支气管狭窄	zhengzhuang/zqgxz/
支气管以下的损伤	zhengzhuang/zqgyxdss/
知觉消失	zhengzhuang/zjxs/
肢端发绀	zhengzhuang/zdfg/
肢端角化	zhengzhuang/zdjh/
肢端接连出现苍白、发组和潮红反应	zhengzhuang/zdjlcxcb_fzhchfy/
肢端溃疡	zhengzhuang/zdky/
肢端凉	zhengzhuang/zdl/
肢端缺血	zhengzhuang/zdqx/
肢端湿冷	zhengzhuang/zdsl/
肢端易发生不易控制的足癣感染	zhengzhuang/zdyfsbykzdzxgr/
肢端硬化	zhengzhuang/zdyh/
肢骨纹状肥大	zhengzhuang/zgwzfd/
肢体不自主震颤	zhengzhuang/ztbzzzc/
肢体的非凹性水肿	zhengzhuang/ztdfaxsz/
肢体短缩畸形	zhengzhuang/ztdsjx/
肢体发凉	zhengzhuang/ztfl/
肢体过度肥大	zhengzhuang/ztgdfd/
肢体忽冷忽热，时红时白	zhengzhuang/zthlhr_shsb/
肢体或躯干麻木	zhengzhuang/zthqgmm/
肢体或躯干姿势异常	zhengzhuang/zthqgzsyc/
肢体僵硬感	zhengzhuang/ztjyg/
肢体局部的皮肤颜色和温度改变	zhengzhuang/ztjbdpfyshwdgb/
肢体麻痛	zhengzhuang/ztmt/
肢体内翻	zhengzhuang/ztnf/
肢体栓塞	zhengzhuang/ztss/
肢体疼痛	zhengzhuang/zttt/
肢体远侧常有麻痛	zhengzhuang/ztyccymt/
肢体远端出现腕垂踝垂	zhengzhuang/ztydcxwchc/
肢体运动不协调	zhengzhuang/ztydbxd/
肢体增长、增粗过度	zhengzhuang/ztzc_zcgd/
肢体障碍	zhengzhuang/ztza/
肢体震颤	zhengzhuang/ztzc/
肢体肿胀	zhengzhuang/ztzz/
脂肪代谢障碍	zhengzhuang/zfdxza/
脂肪过多	zhengzhuang/zfgd/
脂肪浸润	zhengzhuang/zfjr/
脂肪痢	zhengzhuang/zfl/
脂肪泻	zhengzhuang/zfx/
脂膜炎	zhengzhuang/zmy/
脂溶性维生素缺乏	zhengzhuang/zrxwssqf/
脂质沉积症	zhengzhuang/zzcjz/
蜘蛛指	zhengzhuang/zzz/
蜘蛛痣	zhengzhuang/zzz_6150/
直肠肛门内胀痛不适	zhengzhuang/zcgmnztbs/
直肠疼痛	zhengzhuang/zctt/
直肠脱垂	zhengzhuang/zctc/
直肠危象	zhengzhuang/zcwx/
直肠狭窄	zhengzhuang/zcxz/
直肠与肛门狭窄	zhengzhuang/zcygmxz/
直肠重复畸形	zhengzhuang/zczfjx/
直立性低血压晕厥	zhengzhuang/zlxdxyyj/
直立性尿蛋白	zhengzhuang/zlxndb/
直立性脱虚	zhengzhuang/zlxtx/
直腿伸踝试验阳性	zhengzhuang/ztshsyyx/
职业神经症	zhengzhuang/zysjz/
植物神经功能障碍	zhengzhuang/zwsjgnza/
植物血凝素的淋巴细胞返祖现象	zhengzhuang/zwxnsdlbxbfzxx/
跖部纤维痛	zhengzhuang/zbxwt/
跖反射伸性	zhengzhuang/zfssx/
跖纹	zhengzhuang/zw_6167/
跖纹中拇趾球区胫侧弓状纹	zhengzhuang/zwzmzqqjcgzw/
纸样胎儿	zhengzhuang/zyte/
指(趾)骨梗死	zhengzhuang/z_z_ggs/
指(趾)和小腿出现痉挛及隐痛	zhengzhuang/z_z_hxtcxjljyt/
指(趾)甲脆软萎缩	zhengzhuang/z_z_jcrws/
指(趾)甲点状凹陷	zhengzhuang/z_z_jdzax/
指(趾)甲横断	zhengzhuang/z_z_jhd/
指(趾)甲缺失	zhengzhuang/z_z_jqs/
指（趾）甲颜色改变	zhengzhuang/z_z_jysgb/
指(趾)甲增厚	zhengzhuang/z_z_jzh/
指（趾）麻木	zhengzhuang/z_z_mm/
指(趾)肿胀	zhengzhuang/z_z_zz/
指、拇、脘的伸展功能完全丧失	zhengzhuang/z_m_wdszgnwqss/
指、趾甲显现苍白痕或脱落	zhengzhuang/z_zjxxcbhhtl/
指鼻不准	zhengzhuang/zbbz/
指端出现Osler结节	zhengzhuang/zdcxoslerjj/
指端及指(趾)甲周红斑	zhengzhuang/zdjz_z_jzhb/
指骨节肥大	zhengzhuang/zgjfd/
指或趾甲下裂片状出血	zhengzhuang/zhzjxlpzcx/
指甲、耳软骨出现褐色色素沉着	zhengzhuang/zj_ergcxhssscz/
指甲变软或发生变形	zhengzhuang/zjbrhfsbx/
指甲呈半圆形	zhengzhuang/zjcbyx/
指甲呈扁平形	zhengzhuang/zjcbpx/
指甲呈三角形	zhengzhuang/zjcsjx/
指甲呈扇形	zhengzhuang/zjcsx/
指甲呈筒形	zhengzhuang/zjctx/
指甲呈现黑色	zhengzhuang/zjcxhs/
指甲呈现青紫色	zhengzhuang/zjcxqzs/
指甲出现条纹或斑点	zhengzhuang/zjcxtwhbd/
指甲床发绀	zhengzhuang/zjcfg/
指甲倒刺	zhengzhuang/zjdc/
指甲冻伤	zhengzhuang/zjds/
指甲干瘪	zhengzhuang/zjgb/
指甲-骨四联征	zhengzhuang/zj_gslz/
指甲很短	zhengzhuang/zjhd/
指甲厚脆且多裂纹	zhengzhuang/zjhcqdlw/
指甲夹伤	zhengzhuang/zjjs/
指甲尖有缺痕	zhengzhuang/zjjyqh/
指甲可见横沟纺	zhengzhuang/zjkjhgf/
指甲宽而短(宽大于长)	zhengzhuang/zjked_kdyc_/
指甲类似云母	zhengzhuang/zjlsym/
指甲末端呈直线形	zhengzhuang/zjmdczxx/
指甲嵌入肉	zhengzhuang/zjqrr/
指甲翘起	zhengzhuang/zjqq/
指甲上起小细粒	zhengzhuang/zjsqxxl/
指甲上有直线	zhengzhuang/zjsyzx/
指甲生长缓慢	zhengzhuang/zjschm/
指甲失去光泽和平整状态变薄且脆出现白色横纹	zhengzhuang/zjsqgzhpzztbbqccxbshw/
指甲特大有纵纹而手指细	zhengzhuang/zjtdyzweszx/
指甲突然变白	zhengzhuang/zjtrbb/
指甲细长	zhengzhuang/zjxc/
指甲异常	zhengzhuang/zjyc/
指甲易碎	zhengzhuang/zjys/
指甲营养障碍	zhengzhuang/zjyyza/
指甲有红色或黑色斑点	zhengzhuang/zjyhshhsbd/
指甲有黄色细点	zhengzhuang/zjyhsxd/
指甲中央部分隆起	zhengzhuang/zjzybflq/
指尖边缘指甲有凹陷	zhengzhuang/zjbyzjyax/
指间关节不能屈曲	zhengzhuang/zjgjbnqq/
指节垫	zhengzhuang/zjd/
指节增粗	zhengzhuang/zjzc/
指纹皱瘪	zhengzhuang/zwzb/
指趾端干性坏死	zhengzhuang/zzdgxhs/
趾(指)环状缩窄带	zhengzhuang/z_z_hzszd/
趾垂症	zhengzhuang/zcz/
趾端干枯发黑	zhengzhuang/zdgkfh/
趾短小	zhengzhuang/zdx/
趾蹼间隙麻木	zhengzhuang/zpjxmm/
趾远端呈球形	zhengzhuang/zydcqx/
致死性上呼吸道出血	zhengzhuang/zsxshxdcx/
痔出血	zhengzhuang/zcx/
痔核	zhengzhuang/zh/
痔块脱垂	zhengzhuang/zktc/
窒息	zhengzhuang/zx/
智力发育迟缓	zhengzhuang/zlfych/
智力减低	zhengzhuang/zljd/
智能减退	zhengzhuang/znjt/
智能障碍	zhengzhuang/znza/
痣细胞	zhengzhuang/zxb/
中毒性巨结肠	zhengzhuang/zdxjjc/
中毒严重	zhengzhuang/zdyz/
中度昏迷	zhengzhuang/zdhm/
中度或轻度头痛	zhengzhuang/zdhqdtt/
中度精神发育迟滞	zhengzhuang/zdjsfycz/
中度烧伤	zhengzhuang/zdss/
中度痛	zhengzhuang/zdt/
中耳和耳咽管纤毛异常	zhengzhuang/zeheygxmyc/
中骨盆狭窄	zhengzhuang/zgpxz/
中上腹持续性疼痛	zhengzhuang/zsfcxxtt/
中上腹痛	zhengzhuang/zsft/
中枢神经抑制药诱发昏迷	zhengzhuang/zssjyzyyfhm/
中枢性耳聋	zhengzhuang/zsxel/
中枢性发热	zhengzhuang/zsxfr/
中枢性呼吸暂停	zhengzhuang/zsxhxzt/
中暑	zhengzhuang/zs/
中心暗点或弓形暗点	zhengzhuang/zxadhgxad/
中心暗点扩大	zhengzhuang/zxadkd/
中心暗点以及屈光度的改变	zhengzhuang/zxadyjqgddgb/
中心静脉压偏低	zhengzhuang/zxjmypd/
中心静脉压偏高	zhengzhuang/zxjmypg/
中心性钙化	zhengzhuang/zxxgh/
中性粒细胞增高	zhengzhuang/zxlxbzg/
中指半月甲呈粉红色	zhengzhuang/zzbyjcfhs/
中指不明原因痛	zhengzhuang/zzbmyyt/
中指指甲凹陷	zhengzhuang/zzzjax/
钟摆征	zhengzhuang/zbz/
肿瘤性脱发	zhengzhuang/zlxtf/
种植播散	zhengzhuang/zzbs/
种植性结节	zhengzhuang/zzxjj/
重度肥胖	zhengzhuang/zdfp/
重度黄疸	zhengzhuang/zdhd/
重度精神发育迟滞	zhengzhuang/zdjsfycz_6279/
重度贫血	zhengzhuang/zdpx/
重度烧伤	zhengzhuang/zdss_6281/
重度痛	zhengzhuang/zdt_6282/
重力休克	zhengzhuang/zlxk/
重压感、紧箍感或钳夹样头痛	zhengzhuang/zyg_jgghqjytt/
重症肌无力	zhengzhuang/zzjwl/
周期性发作的巩膜充血	zhengzhuang/zqxfzdgmcx/
周期性嗜睡强食症	zhengzhuang/zqxssqsz/
周期性畏寒发热出汗热退症状	zhengzhuang/zqxwhfrchrtzz/
周身不适	zhengzhuang/zsbs/
周身出汗	zhengzhuang/zsch/
周身炎症反应	zhengzhuang/zsyzfy/
周围神经损害	zhengzhuang/zwsjsh/
周围组织灌注不良	zhengzhuang/zwzzgzbl/
粥样泻	zhengzhuang/zyx/
轴性遗忘症	zhengzhuang/zxywz/
肘部的肿胀压痛	zhengzhuang/zbdzzyt/
肘部剧烈疼痛，压痛肿胀	zhengzhuang/zbjltt_ytzz/
肘部扭伤	zhengzhuang/zbns/
肘部外翻角增大	zhengzhuang/zbwfjzd/
肘关节不能屈曲	zhengzhuang/zgjbnqq/
肘关节畸形	zhengzhuang/zgjjx/
肘关节伸直位内翻角增大	zhengzhuang/zgjszwnfjzd/
肘关节脱位	zhengzhuang/zgjtw/
肘管综合征	zhengzhuang/zgzhz/
肘痛	zhengzhuang/zt_6305/
肘外侧夜间痛	zhengzhuang/zwcyjt/
肘外侧肿痛及功能障碍	zhengzhuang/zwcztjgnza/
昼盲	zhengzhuang/zm/
蛛网膜腔内囊肿	zhengzhuang/zwmqnnz/
蛛网膜增厚	zhengzhuang/zwmzh/
蛛网膜粘连	zhengzhuang/zwmzl/
竹节脊柱	zhengzhuang/zjjz/
逐渐加重的右侧腹痛，伴厌食恶心	zhengzhuang/zjjzdycft_bysex/
主动脉瓣上膈膜型狭窄	zhengzhuang/zdmbsgmxxz/
主动脉窦破裂	zhengzhuang/zdmdpl/
主动脉弓右位	zhengzhuang/zdmgyw/
主动脉和肺动脉影偏小	zhengzhuang/zdmhfdmypx/
主动脉环扩张	zhengzhuang/zdmhkz/
注射针眼和手术切口出血	zhengzhuang/zszyhssqkcx/
注视快速运动的物体时头部转动快于眼球运动	zhengzhuang/zsksyddwtstbzdkyyqyd/
注意力不集中	zhengzhuang/zylbjz/
注意力缺乏多动症	zhengzhuang/zylqfddz/
注意障碍	zhengzhuang/zyza/
爪甲和甲床表现为纵行色素带	zhengzhuang/zjhjcbxwzxssd/
爪状趾	zhengzhuang/zzz_6325/
转氨酶异常增高	zhengzhuang/zamyczg/
转氨酶增高	zhengzhuang/zamzg/
状颅皮	zhengzhuang/zlp/
撞击征	zhengzhuang/zjz/
椎动脉迂曲痉挛	zhengzhuang/zdmyqjl/
椎管大小变化	zhengzhuang/zgdxbh/
椎间盘退行性变	zhengzhuang/zjptxxb/
椎间盘脱出	zhengzhuang/zjptc/
椎间隙变化	zhengzhuang/zjxbh/
椎节分裂	zhengzhuang/zjfl/
椎节后缘有骨刺形成	zhengzhuang/zjhyygcxc/
椎前旁软组织肿胀或脓肿	zhengzhuang/zqprzzzzhnz/
椎体结核	zhengzhuang/ztjh/
锥虫性“下疳”	zhengzhuang/zcx_xg_/
锥体束病损	zhengzhuang/ztsbs/
锥体外系损害	zhengzhuang/ztwxsh/
卓-艾综合征	zhengzhuang/z_azhz/
子宫呈横椭圆形	zhengzhuang/zgchtyx/
子宫呈葫芦状	zhengzhuang/zgchlz/
子宫出血	zhengzhuang/zgcx/
子宫穿孔	zhengzhuang/zgck/
子宫附件肿块	zhengzhuang/zgfjzk/
子宫高度低于妊娠周数	zhengzhuang/zggddyrszs/
子宫颈变大	zhengzhuang/zgjbd/
子宫颈扩张	zhengzhuang/zgjkz/
子宫颈有举痛	zhengzhuang/zgjyjt/
子宫痉挛性狭窄环	zhengzhuang/zgjlxxzh/
子宫内膜梗阻	zhengzhuang/zgnmgz/
子宫内膜异位	zhengzhuang/zgnmyw/
子宫内膜增生性病变	zhengzhuang/zgnmzsxbb/
子宫破裂征象	zhengzhuang/zgplzx/
子宫收缩不良	zhengzhuang/zgssbl/
子宫松弛	zhengzhuang/zgsc/
子宫下垂	zhengzhuang/zgxc/
子宫小	zhengzhuang/zgx/
子宫性闭经	zhengzhuang/zgxbj/
子宫压痛	zhengzhuang/zgyt/
子宫硬如板状	zhengzhuang/zgyrbz/
子宫有局限性轻压痛	zhengzhuang/zgyjxxqyt/
子宫增大明显（子宫增大超过胎龄）	zhengzhuang/zgzdmx_zgzdcgtl_/
子痫	zhengzhuang/zx_6366/
子痫症状	zhengzhuang/zxzz/
紫斑	zhengzhuang/zb_6368/
紫癜	zhengzhuang/zd/
紫绀	zhengzhuang/zg_6370/
紫绀和血缺氧	zhengzhuang/zghxqy/
紫红色掌	zhengzhuang/zhsz/
自动Babinske征阳性	zhengzhuang/zdbabinskezyx/
自动症	zhengzhuang/zdz/
自发性骨折	zhengzhuang/zfxgz/
自发性流产	zhengzhuang/zfxlc/
自发性球内出血	zhengzhuang/zfxqncx/
自觉汗臭	zhengzhuang/zjhc/
自恋	zhengzhuang/zl_6379/
自杀行为	zhengzhuang/zsxw/
自我残伤行为	zhengzhuang/zwcsxw/
自我定向障碍	zhengzhuang/zwdxza/
自主神经反射	zhengzhuang/zzsjfs/
自主神经危象	zhengzhuang/zzsjwx/
眦部缺损或眦缺损	zhengzhuang/zbqshzqs/
纵隔病变	zhengzhuang/zgbb/
纵隔淋巴结增生	zhengzhuang/zglbjzs/
纵隔囊肿	zhengzhuang/zgnz/
纵隔纤维化	zhengzhuang/zgxwh/
纵隔阴影	zhengzhuang/zgyy/
纵隔增宽	zhengzhuang/zgzk/
纵隔浊音界扩大	zhengzhuang/zgzyjkd/
纵沟短	zhengzhuang/zgd/
纵行骨折	zhengzhuang/zxgz/
走动性自动症	zhengzhuang/zdxzdz/
足背部肿胀	zhengzhuang/zbbzz/
足背动脉搏动消失	zhengzhuang/zbdmbdxs/
足背及胫后动脉搏动减弱	zhengzhuang/zbjjhdmbdjr/
足不能跖屈和内翻	zhengzhuang/zbnzqhnf/
足部坏疽	zhengzhuang/zbhj/
足部震颤	zhengzhuang/zbzc/
足部肿胀压痛	zhengzhuang/zbzzyt/
足穿孔	zhengzhuang/zck/
足的放射性疼痛	zhengzhuang/zdfsxtt/
足底和足背浮肿	zhengzhuang/zdhzbfz/
足底溃疡	zhengzhuang/zdky_6406/
足底烧灼感	zhengzhuang/zdszg/
足底凸起	zhengzhuang/zdtq/
足底脱皮	zhengzhuang/zdtp/
足跟步行	zhengzhuang/zgbx/
足跟的后上方疼痛的红色肿块	zhengzhuang/zgdhsfttdhszk/
足跟后凸	zhengzhuang/zght/
足跟蓝黑色或黑色斑点	zhengzhuang/zglhshhsbd/
足跟痛	zhengzhuang/zgt/
足跟淤血	zhengzhuang/zgyx/
足和足趾不能背屈	zhengzhuang/zhzzbnbq/
足踝部光滑圆形的包块	zhengzhuang/zhbghyxdbk/
足踝捩伤	zhengzhuang/zhls/
足畸形	zhengzhuang/zjx/
足内翻	zhengzhuang/znf/
足痛	zhengzhuang/zt_6421/
足外翻	zhengzhuang/zwf/
足癣	zhengzhuang/zx_6423/
足掌痛	zhengzhuang/zzt/
足趾发凉怕冷，呈苍白色或紫红色	zhengzhuang/zzflpl_ccbshzhs/
足趾皮肤发黑	zhengzhuang/zzpffh/
足趾屈曲挛缩	zhengzhuang/zzqqls/
足趾伸屈时足部疼痛	zhengzhuang/zzsqszbtt/
足趾痛	zhengzhuang/zzt_6429/
阻塞性黄疸	zhengzhuang/zsxhd/
组胺性面红	zhengzhuang/zaxmh/
组织坏死	zhengzhuang/zzhs/
组织细胞增生	zhengzhuang/zzxbzs/
组织液渗出	zhengzhuang/zzysc/
嘴角降肌发育不良	zhengzhuang/zjjjfybl/
醉汉步态	zhengzhuang/zhbt/
醉酒	zhengzhuang/zj/
左、右腰腹痛	zhengzhuang/z_yyft/
左边脸颊长痘	zhengzhuang/zbljcd/
左侧卧时右腰呈空音，右侧卧时左腰呈浊音	zhengzhuang/zcwsyycky_ycwszyczy/
左腹屈曲	zhengzhuang/zfqq/
左上腹囊性包块有压痛	zhengzhuang/zsfnxbkyyt/
左上腹痛	zhengzhuang/zsft_6443/
左上腹肿块伴有呕血、黑便	zhengzhuang/zsfzkbyox_hb/
左下腹部可触及压痛性包块	zhengzhuang/zxfbkcjytxbk/
左下腹痛	zhengzhuang/zxft/
左心流出道畸形	zhengzhuang/zxlcdjx/
左心室肥厚	zhengzhuang/zxsfh/
左心室腔容量增大	zhengzhuang/zxsqrlzd/
左心衰竭	zhengzhuang/zxsj/
左胸痛	zhengzhuang/zxt/
坐骨大小孔区出现压痛	zhengzhuang/zgdxkqcxyt/
坐骨神经痛	zhengzhuang/zgsjt/
呕吐	zhengzhuang/ot/
搏动性肿块	zhengzhuang/bdxzk/
干呕	zhengzhuang/go/
腰痛	zhengzhuang/yt_6480/
呕血	zhengzhuang/ox/
小儿湿疹	zhengzhuang/xesz/
白带异常	zhengzhuang/bdyc/
月经不调	zhengzhuang/yjbd/
扁桃体发炎	zhengzhuang/bttfy/
肥胖	zhengzhuang/fp/
晒伤	zhengzhuang/ss_6487/
甲状腺结节	zhengzhuang/jzxjj/
房颤	zhengzhuang/fc/
反酸	zhengzhuang/fs_6490/
粘液便	zhengzhuang/zyb/
尿潴留	zhengzhuang/nzl/
恶露不净	zhengzhuang/elbj/
近视	zhengzhuang/js_6494/
假性近视	zhengzhuang/jxjs/
皮疹	zhengzhuang/pz_6496/
脂肪瘤	zhengzhuang/zfl_6497/
妊娠纹	zhengzhuang/rsw/
坏疽	zhengzhuang/hj_6499/
皮肤巩膜黄染	zhengzhuang/pfgmhr/
类风湿结节	zhengzhuang/lfsjj/
月经推迟	zhengzhuang/yjtc/
包皮过长	zhengzhuang/bpgc/
子宫后位	zhengzhuang/zghw/
马牙	zhengzhuang/my_6506/
阴道溃疡	zhengzhuang/ydky/
大便不成形	zhengzhuang/dbbcx/
test66	zhengzhuang/test66/
包皮水肿	zhengzhuang/bpsz/
白发	zhengzhuang/bf_6511/
乳房疼痛	zhengzhuang/rftt/
老年大便失禁	zhengzhuang/lndbsj/
外阴瘙痒	zhengzhuang/wysy/
新生儿呕血和便血	zhengzhuang/xseoxhbx/
月经量少	zhengzhuang/yjls/
灼痛	zhengzhuang/zt_6517/
大咯血	zhengzhuang/dkx/
大便失禁	zhengzhuang/dbsj/
肝大	zhengzhuang/gd/
阴囊潮湿	zhengzhuang/yncs/
