百日咳	brk/
苯中毒	bzd/
喘息样支气管炎	cxyzqgy/
成人呼吸窘迫综合征	crhxjpzhz/
大量羊水吸入	dlysxr/
单纯性肺嗜酸粒细胞浸润症	dcxfsslxbjrz/
大叶性肺炎	dyxfy/
大楼病综合征	dlbzhz/
二硫化碳中毒	elhtzd/
肺、胸膜阿米巴病	f_xmambb/
肺出血－肾炎综合征	fcx_syzhz/
肺放线菌病	ffxjb/
肺泡蛋白沉着症	fpdbczz/
肺曲菌病	fqjb/
放射性肺炎	fsxfy/
肺念珠菌病	fnzjb/
肺大疱	fdp/
肺炎球菌肺炎	fyqjfy/
肺气肿	fqz/
肺泡蛋白质沉积症	fpdbzcjz/
肺炎杆菌肺炎	fygjfy/
肺脓肿	fnz/
肺水肿	fsz/
非典	fd/
肺栓塞	fss/
肺炎	fy/
肺转移瘤	fzyl/
肺大泡	fdp_29/
肺炎性假瘤	fyxjl/
肺隐球菌病	fyqjb/
肺癌	fa/
镉中毒	gzd/
感冒	gm/
感染性休克	grxxk/
过敏性休克	gmxxk/
Goodpasture综合征	goodpasturezhz/
过敏性肺炎	gmxfy/
汞中毒	gzd_43/
呼吸道异物	hxdyw/
呼吸性细支气管相关的间质性肺疾病	hxxxzqgxgdjzxfjb/
呼吸衰竭	hxsj/
呼吸道合胞病毒肺炎	hxdhbbdfy/
减压病	jyb/
急性呼吸衰竭	jxhxsj/
急性肺脓肿	jxfnz/
军团病	jtb/
急性呼吸窘迫综合征	jxhxjpzhz/
军团菌病	jtjb/
结核性脓胸	jhxnx/
金黄色葡萄球菌肺炎	jhsptqjfy/
咖啡因与氨茶碱中毒	kfyyacjzd/
卡氏肺囊虫肺炎	ksfncfy/
咯血	kx/
硫化氢中毒	lhqzd/
老年肺炎	lnfy/
流行性感冒	lxxgm/
免疫缺陷者肺炎	myqxzfy/
镍中毒	nzd/
铍中毒	pzd/
缺血缺氧性脑病	qxqyxnb/
气胸	qx/
球孢子菌病	qbzjb/
禽流感	qlg/
迁延性肺嗜酸粒细胞浸润症	qyxfsslxbjrz/
气管肿瘤	qgzl/
气管先天性疾病	qgxtxjb/
气管、支气管狭窄	qg_zqgxz/
乳酸性酸中毒	rsxszd/
热带性肺嗜酸粒细胞浸润症	rdxfsslxbjrz/
手术后和创伤后肺炎	sshhcshfy/
鼾症	hz/
特发性肺纤维化	tfxfxwh/
脱屑性间质性肺炎	txxjzxfy/
特发性阻塞性细支气管炎伴机化性肺炎	tfxzsxxzqgybjhxfy/
特发性含铁血黄素沉着症	tfxhtxhsczz/
外源性过敏性肺泡炎	wyxgmxfpy/
小儿结核病	xejhb/
新生儿呼吸窘迫综合征	xsehxjpzhz/
吸入性损伤	xrxss/
小儿金黄色葡萄球菌肺炎	xejhsptqjfy/
小儿急性支气管炎	xejxzqgy/
小儿流行性感冒	xelxxgm/
小儿急性喉炎	xejxhy/
矽肺	xf/
新生儿窒息	xsezx/
小儿支原体肺炎	xezytfy/
新生儿肺不张	xsefbz/
小儿感冒	xegm/
哮喘	xc/
小儿哮喘	xexc/
小儿肺炎	xefy/
新生儿呼吸暂停	xsehxzt/
先天性肺囊肿	xtxfnz/
休克型肺炎	xkxfy/
吸入性肺炎	xrxfy/
腺病毒肺炎	xbdfy/
哮喘性肺嗜酸粒细胞浸润症	xcxfsslxbjrz/
细菌性肺炎	xjxfy/
新生儿湿肺	xsesf/
胸壁结核	xbjh/
乙醚中毒	ymzd/
淹溺	yn/
衣原体肺炎	yytfy/
羊水与胎粪吸入综合征	ysytfxrzhz/
一氧化碳中毒	yyhtzd/
阻塞性肺气肿	zsxfqz/
支原体肺炎	zytfy/
支气管扩张	zqgkz/
支气管肺炎	zqgfy/
变应性血管炎	byxxgy/
病毒性心肌炎	bdxxjy/
病态窦房结综合征	btdfjzhz/
川崎病	cqb/
穿透性心脏外伤	ctxxzws/
窦性停搏	dxtb/
单心室	dxs/
单心房	dxf/
单纯性下肢静脉曲张	dcxxzjmqz/
动脉硬化	dmyh/
动脉导管未闭	dmdgwb/
窦性心动过速	dxxdgs/
动脉瘤	dml/
二尖瓣关闭不全	ejbgbbq/
二尖瓣狭窄	ejbxz/
二尖瓣脱垂综合征	ejbtczhz/
二尖瓣环钙化	ejbhgh/
肺性脑病	fxnb/
风湿性二尖瓣狭窄	fsxejbxz/
风湿性二尖瓣关闭不全	fsxejbgbbq/
肥厚型梗阻性心肌病	fhxgzxxjb/
房室管畸形	fsgjx/
法乐四联症	flslz/
风湿热	fsr/
肺动脉口狭窄	fdmkxz/
肥厚型心肌病	fhxxjb/
房室传导阻滞	fscdzz/
肺动静脉瘘	fdjml/
高血压危象	gxywx/
高血压	gxy/
冠状动脉终止异常	gzdmzzyc/
冠状动脉异位起源	gzdmywqy/
感染性心内膜炎	grxxnmy/
冠心病	gxb/
后天性三尖瓣关闭不全	htxsjbgbbq/
后天性动静脉瘘	htxdjml/
间歇性眼球突出症	jxxyqtcz/
急性心肌梗死	jxxjgs/
酒精性心肌病	jjxxjb/
急性心功能不全	jxxgnbq/
急性感染性心内膜炎	jxgrxxnmy/
急性心包炎	jxxby/
急性心力衰竭	jxxlsj/
甲亢	jk/
扩张型心肌病	kzxxjb/
克山病	ksb/
雷诺病	lnb/
慢性肺源性心脏病	mxfyxxzb/
缺血性心肌病	qxxxjb/
四肢血栓性浅静脉炎	szxsxqjmy/
三尖瓣下移畸形	sjbxyjx/
三尖瓣狭窄	sjbxz/
三尖瓣关闭不全	sjbgbbq/
三尖瓣闭锁	sjbbs/
三房心	sfx/
颈动脉体瘤	jdmtl/
完全性肺静脉异位回流	wqxfjmywhl/
完全性大动脉错位	wqxddmcw/
休克	xk/
新生儿缺氧缺血性脑病	xseqyqxxnb/
新生儿硬肿症	xseyzz/
血管瘤	xgl/
先天性风疹	xtxfz/
血栓闭塞性脉管炎	xsbsxmgy/
胸降主动脉动脉瘤	xjzdmdml/
胸主动脉夹层动脉瘤	xzdmjcdml/
心脏神经官能症	xzsjgnz/
心内膜弹性纤维增生症	xnmdxxwzsz/
心绞痛	xjt/
心肌梗塞并发心室间隔穿破	xjgsbfxsjgcp/
心肌梗塞并发二尖瓣关闭不全	xjgsbfejbgbbq/
心肌梗死	xjgs/
心功能障碍	xgnza/
心包囊肿	xbnz/
小儿高血压	xegxy/
小儿充血性心力衰竭	xecxxxlsj/
心肌梗塞并发左心室室壁瘤	xjgsbfzxssbl/
先天性主动脉缩窄	xtxzdmsz/
先天性主动脉弓畸形	xtxzdmgjx/
先天性主动脉瓣下狭窄	xtxzdmbxxz/
先天性主动脉瓣上狭窄	xtxzdmbsxz/
先天性动脉导管未闭	xtxdmdgwb/
先天性动静脉瘘	xtxdjml/
先天性二尖瓣畸形	xtxejbjx/
心包积液	xbjy/
心肌病	xjb/
心律失常	xlsc/
限制型心肌病	xzxxjb/
心房扑动与心房颤动	xfpdyxfcd/
心室内传导阻滞	xsncdzz/
先天性主动脉瓣窦动脉瘤破裂	xtxzdmbddmlpl/
心包肿瘤	xbzl/
血管运动性鼻炎	xgydxby/
胸腔积液	xqjy/
心肌炎	xjy/
心脏内粘液瘤	xznzyl/
心室间隔缺损	xsjgqs/
羊水过多	ysgd/
原发性下肢静脉瓣膜关闭不全	yfxxzjmbmgbbq/
亚急性感染性心内膜炎	yjxgrxxnmy/
乙状窦血栓性静脉炎	yzdxsxjmy/
左心室双出口	zxssck/
左心发育不良	zxfybl/
自发性血胸	zfxxx/
主-肺动脉隔缺损	z_fdmgqs/
主动脉夹层	zdmjc/
主动脉瓣狭窄合并关闭不全	zdmbxzhbgbbq/
主动脉瓣膜部狭窄	zdmbmbxz/
阵发性室上性心动过速	zfxssxxdgs/
早搏	zb/
主动脉瘤	zdml/
主动脉瓣狭窄	zdmbxz/
主动脉瓣关闭不全	zdmbgbbq/
阵发性室性心动过速	zfxsxxdgs/
中暑衰竭	zssj/
阿米巴肝脓肿	ambgnz/
氨基甲酸酯类农药中毒	ajjszlnyzd/
阿米巴肠病	ambcb/
阿片类药物中毒	aplywzd/
柏-查综合征	b_czhz/
Brenneman综合征	brennemanzhz/
巴瑞特综合征	brtzhz/
半乳糖血症	brtxz/
暴发性肝功能衰竭	bfxggnsj/
鞭虫病	bcb/
布卡综合症	bkzhz/
暴发性肝炎样综合征	bfxgyyzhz/
便秘	bm/
吡唑酮类中毒	bztlzd/
Barrett食管	barrettsg/
贲门失弛缓症	bmschz/
钡中毒	bzd_312/
变形杆菌食物中毒	bxgjswzd/
蓖麻子中毒	bmzzd/
铋中毒	bzd_316/
丙型病毒性肝炎	bxbdxgy/
肠病性肢皮炎综合征	cbxzpyzhz/
肠道菌群失调症	cdjqsdz/
肠扭转综合征	cnzzhz/
肠气肿综合征	cqzzhz/
肠系膜淋巴结结核	cxmlbjjh/
肠系膜上动脉压迫综合征	cxmsdmypzhz/
粗制棉子油中毒	czmzyzd/
肠扭转	cnz/
肠套叠	ctd/
肠间脓肿	cjnz/
残胃癌	cwa/
残窦综合征	cdzhz/
肠易激综合征	cyjzhz/
肠梗阻	cgz/
苍耳中毒	cezd/
肠道病毒所致各系统感染	cdbdszgxtgr/
肠系膜上动脉栓塞	cxmsdmss/
肠道气囊肿症	cdqnzz/
餐后血糖过低症	chxtgdz/
肠结核	cjh/
肠系膜上静脉血栓形成	cxmsjmxsxc/
大网膜扭转	dwmnz/
胆道运动功能障碍综合征	ddydgnzazhz/
胆道张力低下综合征	ddzldxzhz/
胆囊管综合征	dngzhz/
胆石性肠绞塞综合征	dsxcjszhz/
胆汁淤积性黄疸	dzyjxhd/
第五日综合征	dwrzhz/
蛋白丧失胃肠综合征	dbsswczhz/
胆囊-结肠肝曲粘连综合征	dn_jcgqzlzhz/
胆石症	dsz/
胆囊切除术后综合征	dnqcshzhz/
大肠息肉	dcxr/
多发性消化道息肉综合征	dfxxhdxrzhz/
大肠梗阻	dcgz/
胆汁性肝硬化	dzxgyh/
丁型病毒性肝炎	dxbdxgy/
胆汁返流性胃炎	dzflxwy/
胆管癌	dga/
大肠类癌	dcla/
毒蕈中毒	dxzd/
敌鼠中毒	dszd/
大肠癌	dca/
大肠恶性淋巴瘤	dcexlbl/
Ehler-Danlos综合征	ehler_danloszhz/
儿童胰腺功能不全并中性粒细胞减少症综合征	etyxgnbqbzxlxbjszzhz/
儿童腹痛	etft/
呃逆症	enz/
非溃疡消化不良	fkyxhbl/
分流性高胆红素血症综合征	flxgdhsxzzhz/
粪类圆线虫病	flyxcb/
腹肌缺如综合征	fjqrzhz/
腹绞痛综合征	fjtzhz/
腹膜后感染与脓肿	fmhgrynz/
腹膜后间隙出血	fmhjxcx/
腹膜后淋巴结炎	fmhlbjy/
腹膜后腔液体渗病	fmhqytsb/
腹膜后疝	fmhs/
腹膜间皮瘤	fmjpl/
腹腔动脉压迫综合征	fqdmypzhz/
腹型癫痫综合征	fxdxzhz/
腹型偏头痛综合征	fxpttzhz/
腹主动脉血栓形成综合征	fzdmxsxczhz/
腹卒中综合征	fzzzhz/
Felty综合征	feltyzhz/
腹痛	ft/
腹膜炎	fmy/
腹泻	fx/
反流性食管炎	flxsgy/
沙门氏菌属食物中毒	smsjsswzd/
放射性肠炎	fsxcy/
福尔马林中毒	femlzd/
发芽马铃薯中毒	fymlszd/
副溶血性弧菌食物中毒	frxxhjswzd/
非寄生虫性肝囊肿	fjscxgnz/
非酒精性脂肪性肝病	fjjxzfxgb/
非霍乱弧菌感染	fhlhjgr/
肛门闭锁	gmbs/
高锰酸钾中毒	gmsjzd/
肝-甲状腺综合征	g_jzxzhz/
肝纤维化	gxwh/
肝肺综合症	gfzhz/
Gardner综合征	gardnerzhz/
功能性呕吐	gnxot/
肝性脊髓病	gxjsb/
肝炎双重感染	gyszgr/
肝炎后综合征	gyhzhz/
膈膨出和麻痹	gpchmb/
肝性脑病	gxnb/
肝硬化	gyh/
肝脓肿	gnz/
功能性消化不良	gnxxhbl/
钩虫病	gcb/
肝腺瘤	gxl/
肝外胆管损伤	gwdgss/
肝损伤	gss/
肝囊肿	gnz_423/
肝包虫囊肿	gbcnz/
膈下脓肿	gxnz/
肝血管瘤	gxgl/
钩虫性十二指肠炎综合征	gcxsezcyzhz/
膈先天性缺损	gxtxqs/
膈疝	gs/
肛管、直肠、结肠狭窄	gg_zc_jcxz/
膈扑动	gpd/
含亚硝酸盐类植物性食物中毒	hyxsylzwxswzd/
化脓性汗腺炎	hnxhxy/
回盲瓣综合征	hmbzhz/
活动盲肠综合征	hdmczhz/
横膈下结肠嵌入综合征	hgxjcqrzhz/
黄疸	hd/
黑色素斑-胃肠多发性息肉综合征	hssb_wcdfxxrzhz/
蛔虫病	hcb/
霍乱样综合征	hlyzhz/
结、直肠黑变病	j_zchbb/
结肠粪性穿孔	jcfxck/
结肠憩室病	jcqsb/
甲醇中毒	jczd/
局部麻醉药中毒	jbmzyzd/
结核性腹膜炎	jhxfmy/
急性胃扩张	jxwkz/
急性化脓性胆管炎	jxhnxdgy/
急性出血性坏死性肠炎	jxcxxhsxcy/
结肠闭锁	jcbs/
结肠直肠损伤	jczcss/
结核性肠系膜淋巴结炎	jhxcxmlbjy/
结肠扭转	jcnz/
结肠瘘	jcl/
结肠癌	jca/
急性胃粘膜病变	jxwzmbb/
急性腐蚀性胃炎	jxfsxwy/
急性单纯性胃炎	jxdcxwy/
假膜性肠炎	jmxcy/
家族性结肠息肉	jzxjcxr/
急性腹膜炎	jxfmy/
酒精性肝病	jjxgb/
甲型肝炎	jxgy/
急性胃肠炎	jxwcy/
结肠息肉	jcxr/
急性胃炎	jxwy/
急性阑尾炎	jxlwy/
巨膀胱-小结肠-肠蠕动不良综合征	jbg_xjc_crdblzhz/
结缔组织性肠炎	jdzzxcy/
急性腹型-高脂血症综合征	jxfx_gzxzzhz/
Turcot综合征	turcotzhz/
急性结肠假性梗阻综合征	jxjcjxgzzhz/
急性胆囊炎	jxdny/
吉尔伯特综合征	jebtzhz/
结石性胆囊炎	jsxdny/
急性胰腺炎	jxyxy/
结肠损伤	jcss/
可拉明中毒	klmzd/
奎宁中毒	knzd/
克罗恩病	kleb/
α1-抗胰蛋白酶缺乏症	1_kydbmqfz/
溃疡性结肠炎	kyxjcy/
磷中毒	lzd/
轮状病毒所致胃肠炎	lzbdszwcy/
类癌	la/
氯丙嗪类中毒	lbqlzd/
氯喹中毒	lkzd/
淋菌性肛门直肠炎	ljxgmzcy/
阑尾寄生虫病	lwjscb/
轮状病毒性肠炎	lzbdxcy/
良性阵发性腹膜炎综合征	lxzfxfmyzhz/
痢疾后综合症	ljhzhz/
蓝色橡皮泡痣综合症	lsxppzzhz/
老年急性阑尾炎	lnjxlwy/
淋巴结-胆道综合征	lbj_ddzhz/
郎-奥韦综合征	l_awzhz/
旅游者腹泻	lyzfx/
慢性胰腺炎	mxyxy/
Milk-Alkali综合征	milk_alkalizhz/
麦胶性肠病	mjxcb/
慢性溃疡性结肠炎	mxkyxjcy/
弥漫性食管痉挛	mmxsgjl/
慢性胃炎	mxwy/
毛石肠梗阻综合征	mscgzzhz/
盲袢综合征	mpzhz/
尼曼－匹克氏病	nm_pksb/
农药中毒	nyzd/
脑肝肾综合征	ngszhz/
浓缩胆汁综合征	nsdzzhz/
诺沃克类病毒胃肠炎	nwklbdwcy/
粘连性肠梗阻	zlxcgz/
囊性纤维化	nxxwh/
脾破裂	ppl/
葡萄球菌食物中毒	ptqjswzd/
硼酸中毒	pszd/
脾功能亢进	pgnkj/
脾-肝综合征	p_gzhz/
Plummer-Vinson综合征	plummer_vinsonzhz/
贲门癌	bma/
盆底痉挛综合症	pdjlzhz/
强酸、强碱中毒	qs_qjzd/
汽油、煤油中毒	qy_myzd/
汽油中毒	qyzd/
强碱类中毒	qjlzd/
驱蛔灵中毒	qhlzd/
缺血性结肠炎	qxxjcy/
缺血性肝炎	qxxgy/
倾倒综合征	qdzhz/
脐膨出-巨舌-巨大躯体综合征	qpc_js_jdqtzhz/
铅中毒	qzd/
乳头状腺瘤	rtzxl/
热带口炎性腹泻	rdkyxfx/
瑞氏综合症	rszhz/
杀虫脒中毒	scmzd/
砷中毒	szd/
水合氯醛中毒	shlqzd/
四氯化碳中毒	slhtzd/
嗜酸细胞性胃肠炎	ssxbxwcy/
食管异物	sgyw/
十二指肠先天性缺如、闭锁和狭窄	sezcxtxqr_bshxz/
十二指肠血管性压迫综合征	sezcxgxypzhz/
神经性呕吐	sjxot/
食管癌	sga/
上消化道出血	sxhdcx/
十二指肠憩室梗阻性黄疸综合征	sezcqsgzxhdzhz/
十二指肠壅积症	sezcyjz/
神经型食物中毒	sjxswzd/
食物中毒	swzd/
食管失弛缓症	sgschz/
食管憩室	sgqs/
食管破裂	sgpl/
食管平滑肌瘤	sgphjl/
食管瘢痕性狭窄	sgbhxxz/
食管贲门粘膜撕裂综合征	sgbmzmslzhz/
输入袢综合征	srpzhz/
食管损伤	sgss/
石膏综合征	sgzhz/
十二指肠憩室	sezcqs/
十二指肠白点综合征	sezcbdzhz/
神经性肠梗阻综合症	sjxcgzzhz/
杀鼠剂中毒	ssjzd/
锑中毒	tzd/
铁中毒	tzd_593/
嗜酸性细胞胃肠炎	ssxxbwcy/
特发性腹膜后纤维化	tfxfmhxwh/
铊中毒	tzd_597/
糖原累积症	tyljz/
特发性非硬化性门脉高压综合征	tfxfyhxmmgyzhz/
吞气症	tqz/
胃癌	wa/
无机磷中毒	wjlzd/
五氯酚钠中毒	wlfnzd/
胃心综合征	wxzhz/
胃损伤	wss/
胃下垂	wxc/
胃轻瘫综合征	wqtzhz/
胃平滑肌肉瘤	wphjrl/
胃扭转	wnz/
胃空肠输入袢综合征	wkcsrpzhz/
胃节律紊乱综合征	wjlwlzhz/
胃肠道外瘘	wcdwl/
胃、十二指肠溃疡急性穿孔	w_sezckyjxck/
胃、十二指肠溃疡出血	w_sezckycx/
胃肠型食物中毒	wcxswzd/
胃泌素瘤	wmsl/
胃肠食物不耐受症	wcswbnsz/
胃肠道功能紊乱	wcdgnwl/
胃粘膜脱垂症	wzmtcz/
胃切除后胆汁返流性胃炎	wqchdzflxwy/
胃潴留	wzl/
胃病	wb/
无胆色素尿性黄疸综合征	wdssnxhdzhz/
吻合口溃疡	whkky/
Whipple病	whippleb/
胃肠道伴癌综合征	wcdbazhz/
戊型病毒性肝炎	wxbdxgy/
网膜肿瘤	wmzl/
网膜原发性节段性梗死	wmyfxjdxgs/
网膜炎	wmy/
网膜囊肿	wmnz/
伪膜性肠炎	wmxcy/
胃息肉	wxr/
胃良性肿瘤	wlxzl/
小肠损伤	xcss/
小儿时期常见的呕吐	xesqcjdot/
先天性肠闭锁与狭窄	xtxcbsyxz/
先天性肠旋转异常	xtxcxzyc/
蝎子螫伤	xzss/
锌中毒	xzd/
消化性溃疡	xhxky/
先天性胆道闭锁	xtxddbs/
消化道重复畸形	xhdzfjx/
小肠系膜损伤	xcxmss/
新生儿胆红素脑病	xsedhsnb/
先天性肥厚性幽门狭窄	xtxfhxymxz/
小儿厌食症	xeysz/
先天性巨结肠	xtxjjc/
小儿呕吐	xeot/
小儿急性胆囊炎	xejxdny/
小肠瘘	xcl/
细菌性肝脓肿	xjxgnz/
下消化道出血	xxhdcx/
小儿消化性溃疡	xexhxky/
小肠吸收不良综合征	xcxsblzhz/
小儿急性胰腺炎	xejxyxy/
心源性肝硬化	xyxgyh/
新生儿呕吐	xseot/
新生儿肝炎综合征	xsegyzhz/
溴中毒	xzd_664/
血吸虫肠病	xxccb/
吸收不良综合征	xsblzhz/
心血管和血栓栓塞综合征	xxghxssszhz/
消化道出血	xhdcx/
先天性食管闭锁	xtxsgbs/
消化系癌伴血液病综合征	xhxabxybzhz/
先天性梅毒性肝硬化	xtxmdxgyh/
血色病	xsb/
细菌性痢疾	xjxlj/
消化道憩室病	xhdqsb/
先天性直肠肛门畸形	xtxzcgmjx/
小儿先天性巨结肠	xextxjjc/
乙胺嘧啶中毒	yamdzd/
乙酰苯胺类中毒	yxbalzd/
有机氯杀虫剂中毒	yjlscjzd/
幽门梗阻	ymgz/
原发性肝内硬化综合征	yfxgnyhzhz/
胰腺损伤	yxss/
胰腺脑病综合征	yxnbzhz/
胰腺假性囊肿	yxjxnz/
药物性胃病	ywxwb/
原发性胆汁性肝硬化	yfxdzxgyh/
营养不良性肝硬化	yyblxgyh/
药物性肝硬化	ywxgyh/
亚硝酸盐中毒	yxsyzd/
银杏中毒	yxzd/
药物性肝病	ywxgb/
乙肝	yg/
异位ACTH综合征	ywacthzhz/
胰胆汁综合征	ydzzhz/
胰胆管合流异常综合征	ydghlyczhz/
原发性腹膜后肿瘤	yfxfmhzl/
鱼肝中毒	ygzd/
鱼胆中毒	ydzd/
原发性肝癌	yfxga/
真菌性食物中毒	zjxswzd/
真菌中毒症	zjzdz/
直肠损伤	zcss/
脂肪肝	zfg/
致死性肝内胆汁淤积综合征	zsxgndzyjzhz/
Zieve综合征	zievezhz/
肿瘤性息肉	zlxxr/
直肠脱垂	zctc/
紫绀-杵状指-肝病综合征	zg_czz_gbzhz/
早孕反应	zyfy/
自发性食管破裂	zfxsgpl/
卓－艾氏综合征	z_aszhz/
真菌性肠炎	zjxcy/
巴特综合征	btzhz/
成人多囊肾	crdns/
产褥感染	crgr/
常染色体显性多囊肾	crstxxdns/
多囊肾	dns/
等渗性脱水	dsxts/
低渗性脱水	dsxts_725/
低钾血症	djxz/
儿童遗尿症	etynz/
恶性高血压性小动脉性肾硬化	exgxyxxdmxsyh/
非特异性尿道炎	ftyxndy/
非IgA系膜增生性肾炎	figaxmzsxsy/
非淋菌性尿道炎	fljxndy/
高渗性脱水	gsxts/
梗阻性尿路疾病	gzxnljb/
高血压肾病	gxysb/
肝源性肾损害	gyxssh/
高钾血症	gjxz/
间质性膀胱炎	jzxbgy/
急性风湿热肾损害	jxfsrssh/
急性肾盂肾炎	jxsysy/
急性肾功能衰竭	jxsgnsj/
急性肾小管坏死	jxsxghs/
间质性肾炎	jzxsy/
急进性肾炎	jjxsy/
近端(Ⅱ型)肾小管性酸中毒	jd__x_sxgxszd/
急性肾炎	jxsy/
急性肾小管间质性肾炎	jxsxgjzxsy/
急性肾炎综合征	jxsyzhz/
局灶性肾小球硬化症	jzxsxqyhz/
良性高血压性小动脉性肾硬化	lxgxyxxdmxsyh/
流行性出血热	lxxcxr/
狼疮性肾炎	lcxsy/
链球菌感染后的急性肾小球肾炎	lqjgrhdjxsxqsy/
类风湿性关节炎肾损害	lfsxgjyssh/
慢性呼吸衰竭	mxhxsj/
免疫介导性肾脏病	myjdxszb/
慢性肾功能衰竭	mxsgnsj/
膜性肾小球肾炎	mxsxqsy/
慢性肾盂肾炎	mxsysy/
慢性肾炎	mxsy/
尿路真菌感染	nlzjgr/
尿失禁	nsj/
尿道炎	ndy/
尿崩症	nbz/
尿道结石	ndjs/
钠过多	ngd/
尿路感染	nlgr/
膀胱炎	bgy/
膀胱颈挛缩	bgjls/
膀胱癌	bga/
溶血尿毒综合征	rxndzhz/
肾前性肾功能衰竭	sqxsgnsj/
肾结核对侧肾积水	sjhdcsjs/
肾及输尿管重复畸形	sjsngzfjx/
神经源性膀胱	sjyxbg/
输尿管损伤	sngss/
肾发育不全	sfybq/
肾积水	sjs/
肾硬化症	syhz/
肾及输尿管结石	sjsngjs/
肾结核	sjh/
肾病综合征	sbzhz/
肾下垂	sxc/
肾石症	ssz/
肾血管性高血压	sxgxgxy/
双侧先天性肾上腺皮质增生	scxtxssxpzzs/
肾上腺皮质功能减退症	ssxpzgnjtz/
水过多	sgd/
烧伤后急性肾功能衰竭	sshjxsgnsj/
肾脏损伤	szss/
肾动脉粥样栓塞	sdmzyss/
肾囊肿	snz/
肾细胞癌	sxba/
肾盂肾炎	sysy/
肾小管性酸中毒	sxgxszd/
肾动脉闭塞	sdmbs/
蹄铁形肾	ttxs/
特异性肾实质疾病	tyxsszjb/
糖尿病肾病	tnbsb/
微小病变性肾病	wxbbxsb/
血尿	xn/
小儿原发性肾病综合征	xeyfxsbzhz/
小儿尿感	xeng/
小儿慢性肾功能衰竭	xemxsgnsj/
小儿急性肾功能衰竭	xejxsgnsj/
小儿肾小管性酸中毒	xesxgxszd/
婴幼儿阴道炎	yyeydy/
阴茎纤维性海绵体炎	yjxwxhmty/
遗尿症	ynz/
原发性小血管炎性肾损害	yfxxxgyxssh/
原发性IgA肾病	yfxigasb/
隐匿性肾小球肾炎	ynxsxqsy/
中毒性肾病	zdxsb/
紫癜性肾炎	zdxsy/
癌性神经肌病	axsjjb/
阿尔茨海默病	aechmb/
安眠药中毒	amyzd/
阿片中毒	apzd/
臂丛神经痛	bcsjt/
Creutzfeldt-Jakob病	creutzfeldt_jakobb/
痴呆综合征	cdzhz_837/
纯植物神经功能衰竭	czwsjgnsj/
丛集性头痛	cjxtt/
多发性硬化	dfxyh/
动眼、滑车及外展神经疾病	dy_hcjwzsjjb/
多发性神经炎	dfxsjy/
多发性末梢神经炎	dfxmssjy/
短暂性脑缺血发作	dzxnqxfz/
大便失禁	dbsj/
儿童学习能力障碍	etxxnlza/
儿童口吃	etkc/
耳源性脑脓肿	eyxnnz/
风湿性舞蹈病	fsxwdb/
腓总神经损害	fzsjsh/
吩噻嗪类抗精神病药物中毒	fsqlkjsbywzd/
膈肌麻痹	gjmb/
格林－巴利综合征	gl_blzhz/
肝豆状核变性	gdzhbx/
海绵窦血栓	hmdxs/
昏迷	hm/
昏厥	hj/
颈椎病	jzb/
僵人综合征	jrzhz/
急性脊髓炎	jxjsy/
脊髓压迫症	jsypz/
延髓进行性麻痹	ysjxxmb/
结节性硬化病	jjxyhb/
脊髓亚急性联合变性	jsyjxlhbx/
脊髓血管病	jsxgb/
紧张性头痛	jzxtt/
脊神经根炎	jsjgy/
酒精中毒	jjzd/
急性中毒性脑炎	jxzdxny/
老年痴呆	lncd/
雷诺综合征	lnzhz/
老年眩晕	lnxy/
老年性耳聋	lnxel/
淋巴细胞脉络丛脑膜炎	lbxbmlcnmy/
末梢神经炎	mssjy/
慢性进行性舞蹈病	mxjxxwdb/
麻痹性臂丛神经炎	mbxbcsjy/
面神经炎	msjy/
脑出血	ncx/
脑血栓	nxs/
脑肺吸虫病	nfxcb/
脑动脉硬化症	ndmyhz/
脑脓肿	nnz/
脑梗塞	ngs/
脑性瘫痪综合征	nxthzhz/
皮肌炎	pjy/
偏头痛	ptt/
帕金森病	pjsb/
氰化物中毒	qhwzd/
全植物神经功能不全	qzwsjgnbq/
前庭神经炎	qtsjy/
桡神经麻痹	rsjmb/
上矢状窦血栓性静脉炎	sszdxsxjmy/
三环类抗忧郁药中毒	shlkyyyzd/
肾上腺素中毒	ssxszd/
士的宁中毒	sdnzd/
神经系统的放射性损伤	sjxtdfsxss/
手足徐动症	szxdz/
视神经炎	ssjy/
视神经萎缩	ssjws/
神经症	sjz/
Shy-Drager综合征	shy_dragerzhz/
头-面血管瘤综合征	t_mxglzhz/
舌咽神经痛	sysjt/
视束病变	ssbb/
神经鞘瘤	sjql/
神经衰弱	sjsr/
神经梅毒	sjmd/
糖尿病性神经病	tnbxsjb/
头痛	tt/
羰基镍中毒	tjnzd/
位置性眩晕	wzxxy/
小儿结核性脑膜炎	xejhxnmy/
溴氯菊酯中毒	xljzzd/
小舞蹈病	xwdb/
新生儿惊厥	xsejj/
小儿脑瘫	xent/
运动神经元疾病	ydsjyjb/
意识障碍	ysza/
有机磷农药中毒	yjlnyzd/
晕厥	yj/
咽肌麻痹	yjmb/
遗传性共济失调	ycxgjsd/
运动神经元病	ydsjyb/
晕动病	ydb/
咽部神经鞘膜瘤	ybsjqml/
压迫性视神经病变	ypxssjbb/
正中神经损伤	zzsjss/
躁狂症	zkz/
中枢神经兴奋药中毒	zssjxfyzd/
镇静、安定、催眠药中毒	zj_ad_cmyzd/
直立性低血压	zlxdxy/
植物神经功能紊乱	zwsjgnwl/
周期性麻痹	zqxmb/
重症肌无力危象	zzjwlwx/
重症肌无力	zzjwl/
枕大神经痛	zdsjt/
蛛网膜炎	zwmy/
周期性瘫痪	zqxth/
周围神经病损	zwsjbs/
ADH分泌过多综合征	adhfmgdzhz/
闭经	bj/
垂体瘤	ctl/
成人全垂体功能减退	crqctgnjt/
垂体危象与垂体卒中	ctwxyctzz/
垂体前叶机能减退症	ctqyjnjtz/
垂体性矮小病	ctxaxb/
单纯性甲状腺肿	dcxjzxz/
多囊卵巢综合征	dnlczhz/
单纯性肥胖	dcxfp/
多腺体缺陷综合征	dxtqxzhz/
多发性内分泌肿瘤综合征Ⅰ型	dfxnfmzlzhz_x/
低血糖症	dxtz/
代谢性碱中毒	dxxjzd/
代谢性酸中毒	dxxszd/
儿童睡眠障碍	etsmza/
肥胖症	fpz/
高渗性非酮症性糖尿病昏迷	gsxftzxtnbhm/
高血脂	gxz/
骨质疏松	gzss/
Graves病	gravesb/
黄瘤	hl/
呼吸性碱中毒	hxxjzd/
呼吸性酸中毒	hxxszd/
甲状腺功能减退	jzxgnjt/
甲状腺功能正常的甲状腺肿大	jzxgnzcdjzxzd/
静止性淋巴细胞性甲状腺炎	jzxlbxbxjzxy/
甲状腺腺瘤	jzxxl/
甲状腺舌管囊肿与瘘	jzxsgnzyl/
继发性肾上腺功能不足	jfxssxgnbz/
急性颌下腺炎	jxhxxy/
急性乳腺炎	jxrxy/
急性淋巴结炎	jxlbjy/
假性甲状旁腺功能减退症	jxjzpxgnjtz/
继发性甲状旁腺功能亢进症	jfxjzpxgnkjz/
脚气病	jqb/
巨人症及肢端肥大症	jrzjzdfdz/
基底细胞腺瘤	jdxbxl/
颈部淋巴结结核	jblbjjh/
库欣综合征	kxzhz/
克兰费尔特综合征	klfetzhz/
慢性淋巴细胞性甲状腺炎	mxlbxbxjzxy/
泌乳素瘤	mrsl/
慢性淋巴结炎	mxlbjy/
男性乳房肥大症	nxrffdz/
男性生殖腺机能减退症	nxszxjnjtz/
粘多糖沉积病	zdtcjb/
男子乳房发育症	nzrffyz/
内分泌性眼球突出	nfmxyqtc/
皮脂腺痣	pzxz/
气管支气管异物	qgzqgyw/
雀斑	qb/
乳腺增生	rxzs/
乳腺癌	rxa/
乳溢	ry/
乳头状囊腺癌	rtznxa/
肾上腺危象	ssxwx/
舌扁平苔藓	sbptx/
松果体瘤	sgtl/
嗜酸性腺瘤	ssxxl/
嗜铬细胞瘤	sgxbl/
糖尿病乳酸性酸中毒	tnbrsxszd/
糖尿病酮症酸中毒	tnbtzszd/
糖尿病足	tnbz/
维生素C缺乏病	wsscqfb/
维生素D中毒症	wssdzdz/
维生素E缺乏病	wsseqfb/
外科皮脂腺囊肿	wkpzxnz/
外科淋巴管瘤	wklbgl/
新生儿低血糖症与高血糖症	xsedxtzygxtz/
涎瘘	xl/
胸腺瘤	xxl/
血卟啉病	xblb/
涎腺病毒病	xxbdb/
涎石病	xsb_1062/
下丘脑疾病	xqnjb/
性变态	xbt/
腺样体肥大	xytfd/
涎腺囊肿	xxnz/
腺泡细胞癌	xpxba/
涎腺的未分化癌	xxdwfha/
涎腺结核	xxjh/
腺样囊性癌	xynxa/
腺淋巴瘤	xlbl/
涎腺混合瘤	xxhhl/
亚急性甲状腺炎	yjxjzxy/
原发性醛固酮增多症	yfxqgtzdz/
c胰岛功能性β细胞瘤	cydgnxxbl/
胰岛素瘤	ydsl/
原发性甲状旁腺功能亢进症	yfxjzpxgnkjz/
溢乳闭经综合征	yrbjzhz/
白细胞减少症和粒细胞缺乏症	bxbjszhlxbqfz/
白血病	bxb/
白血病性咽峡炎	bxbxyxy/
出血性疾病	cxxjb/
单纯红细胞再障性贫血	dchxbzzxpx/
低钙血症和低镁血症	dgxzhdmxz/
地中海贫血	dzhpx/
多发性骨髓瘤	dfxgsl/
恶性组织细胞病	exzzxbb/
恶性淋巴瘤	exlbl/
非酮症高血糖-高渗性昏迷	ftzgxt_gsxhm/
复合型酸碱失衡	fhxsjsh/
骨髓痨性贫血	gslxpx/
骨髓纤维化	gsxwh/
骨髓增生异常综合征	gszsyczhz/
过敏性紫癜	gmxzd/
何杰金病	hjjb/
获得性血小板功能障碍	hdxxxbgnza/
获得性循坏抗凝物质增多综合征	hdxxhknwzzdzhz/
化脓性骨髓炎	hnxgsy/
霍奇金淋巴瘤	hqjlbl/
菌血症	jxz/
巨球蛋白血症	jqdbxz/
急性白血病	jxbxb/
巨幼细胞性贫血	jyxbxpx/
急性淋巴细胞性白血病	jxlbxbxbxb/
淋巴细胞减少症	lbxbjsz/
镰状细胞病	lzxbb/
类白血病反应	lbxbfy/
粒细胞缺乏症	lxbqfz/
绿色瘤	lsl/
镁过多症	mgdz/
镁缺乏症	mqfz/
慢性疾病的贫血	mxjbdpx/
弥散性血管内凝血	msxxgnnx/
慢性骨髓炎	mxgsy/
慢性粒细胞性白血病	mxlxbxbxb/
慢性淋巴细胞性白血病	mxlbxbxbxb/
尿道上裂	ndsl/
充血性脾肿大	cxxpzd/
贫血	px/
破伤风	psf/
脾功能亢进症	pgnkjz/
葡萄糖-6-磷酸脱氢酶缺乏症	ptt_6_lstqmqfz/
缺铁性贫血	qtxpx/
溶血过度所致贫血	rxgdszpx/
溶血性贫血	rxxpx/
失血性休克	sxxxk/
嗜酸性细胞增多症	ssxxbzdz/
特发性高嗜酸性细胞综合征	tfxgssxxbzhz/
特发性血小板减少性紫癜	tfxxxbjsxzd/
铁利用性贫血	tlyxpx/
维生素K缺乏病	wsskqfb/
维生素B12缺乏所致贫血	wssb12qfszpx/
小儿过敏性紫瘢	xegmxzb/
血栓性血小板减少性紫癜	xsxxxbjsxzd/
血小板减少症	xxbjsz/
血友病	xyb/
新生儿败血症	xsebxz/
新生儿溶血病	xserxb/
血管母细胞瘤	xgmxbl/
先天性红细胞膜病	xtxhxbmb/
血管性血友病	xgxxyb/
遗传性血色病	ycxxsb/
叶酸缺乏所致贫血	ysqfszpx/
遗传性出血性毛细血管扩张症	ycxcxxmxxgkzz/
营养性巨幼红细胞性贫血	yyxjyhxbxpx/
原发性血小板减少性紫瘢	yfxxxbjsxzb/
原发性血小板增多症	yfxxxbzdz/
异常血红蛋白病	ycxhdbb/
中性白(粒)细胞减少症	zxb_l_xbjsz/
组织细胞增殖症	zzxbzzz/
再生障碍性贫血	zszaxpx/
自身免疫性溶血性贫血	zsmyxrxxpx/
真性红细胞增多症	zxhxbzdz/
阵发性睡眠性血红蛋白尿	zfxsmxxhdbn/
白塞综合征	bszhz/
白塞病	bsb/
Behcet病	behcetb/
迟发性低丙球血症	cfxdbqxz/
常年性鼻炎	cnxby/
多发性大动脉炎	dfxddmy/
多发性肌炎	dfxjy/
大骨节病	dgjb/
淀粉样变病	dfybb/
二水焦磷酸钙结晶沉积症	esjlsgjjcjz/
风湿性多肌痛	fsxdjt/
肥大细胞增多症	fdxbzdz/
过敏性哮喘	gmxxc/
高尿酸血症	gnsxz/
干燥综合征	gzzhz/
骨关节炎	ggjy/
红斑狼疮	hblc/
混合结缔组织病	hhjdzzb/
碱性磷酸钙结晶沉积病	jxlsgjjcjb/
巨细胞动脉炎	jxbdmy/
结节性多动脉炎	jjxddmy/
结节性脂膜炎	jjxzmy/
急性化脓性腱鞘炎	jxhnxjqy/
结节病	jjb/
肩关节结核	jgjjh/
急性淋巴管炎	jxlbgy/
枯草热	kcr/
类风湿关节炎	lfsgjy/
慢性皮肤粘膜念珠菌病	mxpfzmnzjb/
慢性肉芽肿病	mxryzb/
皮下脂质肉芽肿病	pxzzryzb/
盘状红斑狼疮	pzhblc/
皮肤过敏	pfgm/
强直性脊柱炎	qzxjzy/
羟磷灰石沉积病	qlhscjb/
气性坏疽	qxhj/
Reiter综合征	reiterzhz/
乳房纤维瘤	rfxwl/
软组织肿瘤	rzzzl/
嗜酸性筋膜炎	ssxjmy/
Ⅳ型超敏反应性疾病	_xcmfyxjb/
Ⅲ型超敏反应性疾病	_xcmfyxjb_1237/
手掌深部间隙感染	szsbjxgr/
食物变应性和不耐受性	swbyxhbnsx/
痛风	tf/
痛风性关节炎	tfxgjy/
物理性变应性	wlxbyx/
小儿风湿热	xefsr/
先天性胸腺发育不全	xtxxxfybq/
血清病	xqb/
选择性IgA缺乏症	xzxigaqfz/
纤维瘤病	xwlb/
新生儿皮下坏疽	xsepxhj/
原发性免疫缺陷病	yfxmyqxb/
银屑病关节炎	yxbgjy/
遗传性补体缺陷病	ycxbtqxb/
遗传性血管性水肿	ycxxgxsz/
药物过敏	ywgm/
严重联合免疫缺陷病	yzlhmyqxb/
Ⅰ型超敏反应性疾病	_xcmfyxjb_1259/
硬皮病	ypb/
重叠综合征	zdzhz/
创伤性窒息	csxzx/
创伤性气胸	csxqx/
动脉硬化性闭塞症	dmyhxbsz/
肺栓塞和肺梗死	fsshfgs/
肺错构瘤	fcgl/
肺爆震伤	fbzs/
肺包虫病	fbcb/
感染性肋软骨炎	grxlrgy/
膈肌膨出	gjpc/
急性气管－支气管炎	jxqg_zqgy/
鸡胸	jx/
矫正型大动脉错位	jzxddmcw/
继发性纵隔感染	jfxzggr/
局限型间皮瘤	jxxjpl/
急性脓胸	jxnx/
肋骨骨折	lggz/
联合瓣膜病变	lhbmbb/
漏斗胸	ldx/
慢性支气管炎	mxzqgy/
慢性缩窄性心包炎	mxszxxby/
慢性心功能不全	mxxgnbq/
慢性心包炎	mxxby/
慢性心力衰竭	mxxlsj/
梅毒性心血管病	mdxxxgb/
慢性肺炎	mxfy/
慢性脓胸	mxnx/
乳头肌功能不全	rtjgnbq/
食管裂孔疝	sglks/
损伤性休克	ssxxk/
缩窄性心包炎	szxxby/
外伤性乳糜胸	wsxrmx/
心脏穿透伤	xzcts/
胸骨骨折	xggz/
限制型心脏病	xzxxzb/
胸廓出口综合征	xkckzhz/
先天性膈疝	xtxgs/
心性猝死综合征	xxcszhz/
心脏钝性闭合伤	xzdxbhs/
原发性心脏肿瘤	yfxxzzl/
右心室双出口	yxssck/
永存动脉干	ycdmg/
预激综合征	yjzhz/
原发性纵隔感染	yfxzggr/
原发性纵隔肿瘤	yfxzgzl/
纵隔脓肿	zgnz/
转移性胸膜肿瘤	zyxxmzl/
搏动性眼球突出症	bdxyqtcz/
创伤性枢椎前滑脱	csxszqht/
侧脑室肿瘤	cnszl/
第四脑室肿瘤	dsnszl/
顶叶肿瘤	dyzl/
短颈畸形	djjx/
多发性颅内血肿	dfxlnxz/
蝶窦恶性肿瘤	ddexzl/
第三脑室肿瘤	dsnszl_1432/
额叶肿瘤	eyzl/
耳源性脑积水	eyxnjs/
耳内脑膜脑疝	ennmns/
高血压性脑出血	gxyxncx/
高血压脑病	gxynb/
寰椎骨折脱位	hzgztw/
系统性红斑狼疮	xtxhblc/
颈椎半脱位	jzbtw/
颈椎骨折脱位	jzgztw/
颈椎管狭窄症	jzgxzz/
颈椎过伸性损伤	jzgsxss/
颈椎后脱位	jzhtw/
颈椎后纵韧带骨化症	jzhzrdghz/
颈椎黄韧带骨化症	jzhrdghz/
颈椎结核	jzjh/
颈椎小关节创伤性退变性关节炎	jzxgjcsxtbxgjy/
颈椎椎弓裂	jzzgl/
基底节血肿	jdjxz/
急性单纯疱疹病毒性脑炎	jxdcpzbdxny/
急性颈椎间盘突出症	jxjzjptcz/
脊椎结核	jzjh_1455/
脊柱裂	jzl/
肌营养不良症	jyyblz/
急性硬脑膜外血肿	jxynmwxz/
急性和亚急性硬脑膜下血肿	jxhyjxynmxxz/
急性及亚急性脑内血肿	jxjyjxnnxz/
脊髓小脑变性症	jsxnbxz/
颅骨骨髓炎	lggsy/
颅骨缺损	lgqs/
颅底骨折	ldgz/
颅内动脉瘤	lndml/
颅内低压性头痛	lndyxtt/
颅内占位性病变引起的头痛	lnzwxbbyqdtt/
颅内转移瘤	lnzyl/
帽状腱膜下脓肿	mzjmxnz/
面神经损伤	msjss/
慢性硬脑膜外血肿	mxynmwxz/
脑室炎	nsy/
脑性瘫痪	nxth/
脑囊虫病	nncb/
脑疝	ns/
脑蛛网膜下腔出血	nzwmxqcx/
脑震荡	nzd_1482/
脑血栓形成	nxsxc/
脑损伤后综合征	nsshzhz/
脑室内出血	nsncx/
脑脊液漏	njyl/
脑弓形体病	ngxtb/
脑挫裂伤	ncls/
脑膜炎	nmy/
脑积水	njs/
脑结核瘤	njhl/
脑垂体腺瘤	nctxl/
脑膜瘤	nml/
皮脂腺囊肿	pzxnz/
迁延性昏迷	qyxhm/
丘脑下部损伤	qnxbss/
上皮样囊肿	spynz/
神经胶质瘤	sjjzl/
散发性脑炎	sfxny/
头皮血肿	tpxz/
听神经鞘瘤	tsjql/
外伤性颈内动脉海绵窦瘘	wsxjndmhmdl/
外伤性癫痫	wsxdx/
外伤后脑脂肪栓塞	wshnzfss/
外伤后脑膨出	wshnpc/
外伤后颅内积气	wshlnjq/
外伤后低颅压综合征	wshdlyzhz/
外伤后头痛	wshtt/
外伤性硬脑膜下积液	wsxynmxjy/
先天性脑积水	xtxnjs/
新生儿颅内出血	xselncx/
小脑扁桃体疝	xnbtts/
先天性肿瘤	xtxzl/
硬脑膜下血肿	ynmxxz/
蛛网膜下腔出血	zwmxqcx/
中风	zf/
周围神经损伤	zwsjss/
胆囊癌	dna/
胆囊腺肌增生病	dnxjzsb/
胆结石	djs/
胆管良性狭窄	dglxxz/
胆管扩张症	dgkzz/
胆管结石与胆管炎	dgjsydgy/
胆道蛔虫病	ddhcb/
胆道出血	ddcx/
乏特壶腹周围癌	fthfzwa/
肝棘球蚴病	gjqyb/
肝性血卟啉病综合征	gxxblbzhz/
肝内胆管结石	gndgjs/
肝包虫病	gbcb/
环状胰腺	hzyx/
急性结石性胆囊炎	jxjsxdny/
急性出血坏死型胰腺炎	jxcxhsxyxy/
溃疡病急性穿孔	kybjxck/
慢性胆囊炎	mxdny/
慢性胆管炎	mxdgy/
门静脉高压症	mjmgyz/
生长激素释放抑制素瘤	scjssfyzsl/
胰腺癌	yxa/
胰腺囊腺癌	yxnxa/
原发性硬化性胆管炎	yfxyhxdgy/
异位胰腺	ywyx/
胰腺外伤	yxws/
胰腺囊肿	yxnz/
胰腺脓肿	yxnz_1593/
胰腺瘘	yxl/
胰腺多肽瘤	yxdtl/
胰石症	ysz/
胰岛细胞类癌	ydxbla/
包皮龟头炎	bpgty/
包皮阴茎头炎	bpyjty/
附睾炎	fgy/
非细菌性前列腺炎	fxjxqlxy/
梗阻性肾病	gzxsb/
睾丸扭转	gwnz/
后尿道瓣膜	hndbm/
结核性膀胱挛缩	jhxbgls/
结核性膀胱自发破裂	jhxbgzfpl/
急性膀胱炎	jxbgy/
精索静脉曲张	jsjmqz/
男生殖系结核	nszxjh/
尿道下裂	ndxl/
尿路梗阻	nlgz/
尿瘘	nl/
尿道创伤	ndcs/
尿道狭窄	ndxz/
尿道损伤	ndss/
男性尿道癌	nxnda/
女性尿道癌	nxnda_1626/
膀胱损伤	bgss/
膀胱结石	bgjs/
膀胱瘘	bgl/
膀胱外翻	bgwf/
脐尿管囊肿及脐尿管瘘	qngnzjqngl/
鞘膜积液	qmjy/
前列腺增生	qlxzs/
前列腺炎	qlxy/
前列腺癌	qlxa/
射精功能障碍	sjgnza/
肾上腺性征异常症	ssxxzycz/
肾损伤	sss/
输尿管结石	sngjs/
肾创伤	scs/
肾上腺髓质功能亢进	ssxszgnkj/
肾皮质髓质脓肿	spzsznz/
肾皮质脓肿	spznz/
肾周脓肿	sznz/
肾盂癌	sya/
肾胚胎瘤	sptl/
肾盂肿瘤和输尿管肿瘤	syzlhsngzl/
肾癌	sa/
隐睾	yg_1662/
遗精	yj_1663/
阴茎异常勃起	yjycbq/
婴幼儿外阴炎	yyewyy/
阴茎硬结症	yjyjz/
I型肾小管性酸中毒	ixsxgxszd/
白线疝	bxs/
成人脐疝	crqs/
穿腹膜疝	cfms/
儿童遗粪症	etyfz/
腹膜后血肿	fmhxz/
腹内疝	fns/
腹股沟直疝（疝气）	fggzs_sq_/
腹股沟斜疝	fggxs/
粪瘘	fl/
肛窦炎	gdy/
肛瘘	gl/
肛门瘙痒症	gmsyz/
肛门失禁	gmsj/
肛门外伤	gmws/
肛门异位	gmyw/
肛乳头炎	grty/
肛周脓肿	gznz/
骨盆直肠脓肿	gpzcnz/
肛门直肠周围脓肿	gmzczwnz/
肛裂	gl_1699/
肛周湿疹	gzsz/
孤立性直肠溃疡综合征	glxzckyzhz/
肛提肌综合征	gtjzhz/
会阴裂伤	hyls/
结肠过敏症	jcgmz/
急性出血性坏死性小肠炎	jxcxxhsxxcy/
结肠脂肪瘤	jczfl/
溃疡病大出血	kybdcx/
蓝氏贾第鞭毛虫病	lsjdbmcb/
盲肠肉芽肿	mcryz/
内痔	nz/
蛲虫病	ncb/
外痔	wz/
先天性直肠与周围脏器瘘	xtxzcyzwzql/
直肠息肉	zcxr/
直肠癌	zca/
痔疮	zc/
直肠内异物	zcnyw/
坐骨直肠窝脓肿	zgzcwnz/
直肠重复畸形	zczfjx/
直肠阴道瘘	zcydl/
直肠前突	zcqt/
直肠闭锁	zcbs/
扁平足	bpz/
髌骨骨折	bggz/
髌骨软化症	bgrhz/
变形性骨炎	bxxgy/
剥脱性骨软骨炎	btxgrgy/
髌股关节疼痛	bggjtt/
鼻骨骨折	bggz_1759/
耻骨结核	cgjh/
尺桡骨干双骨折	crggsgz/
成骨不全	cgbq/
尺骨上1/3骨折合并桡骨头脱位	cgs1_3gzhbrgttw/
尺骨下1/3骨折合并下尺桡关节脱位	cgx1_3gzhbxcrgjtw/
尺桡骨干骨折	crgggz/
脆弱性骨硬化	crxgyh/
创伤性肘关节炎	csxzgjy/
尺骨鹰嘴骨折	cgyzgz/
成软骨细胞瘤	crgxbl/
第三腰椎横突综合征	dsyzhtzhz/
动脉瘤样骨囊肿	dmlygnz/
断指再植	dzzz/
多发性骨骺发育异常	dfxghfyyc/
点状骨骺发育异常	dzghfyyc/
单侧关节突关节脱位	dcgjtgjtw/
骶髂关节结核	dqgjjh/
骶髂关节扭伤	dqgjns/
风湿性关节炎	fsxgjy/
腓骨近端骨折	fgjdgz/
Friedreich共济失调症	friedreichgjsdz/
腓骨肌萎缩症	fgjwsz/
骨肉瘤	grl/
骨折	gz/
感染性关节炎	grxgjy/
关节脱位	gjtw/
跟骨骨折	gggz/
肱骨干骨折	ggggz/
肱骨髁上骨折	ggksgz/
肱骨内髁骨折	ggnkgz/
肱骨外髁骨折	ggwkgz/
佝偻病	glb/
股骨粗隆间骨折	ggcljgz/
股骨干骨折	ggggz_1801/
骨硬化病	gyhb/
骨放线菌病	gfxjb/
骨化性肌炎	ghxjy/
骨巨细胞瘤	gjxbl/
骨囊肿	gnz_1806/
骨盆骨折	gpgz/
骨纤维异常增殖症	gxwyczzz/
骨软骨瘤	grgl/
肱骨小头骨折	ggxtgz/
骨干续连症	ggxlz/
骨与关节结核	gygjjh/
骨肿瘤	gzl/
股骨大粗隆结核	ggdcljh/
肱骨远端全骺分离	ggydqhfl/
肱骨内上髁骨折	ggnskgz/
骨包囊虫病	gbncb/
股骨头骨骺骨软骨病	ggtghgrgb/
骨样骨瘤	gygl/
骨髓炎	gsy/
肱骨外上髁炎	ggwsky/
腘肌腱损伤	gjjss/
跟腱前囊炎	gjqny/
骨与关节梅毒	gygjmd/
骨外软骨肉瘤	gwrgrl/
骨旁骨肉瘤	gpgrl/
骨膜性软骨肉瘤	gmxrgrl/
骨的原发性淋巴瘤	gdyfxlbl/
骨雅司病	gysb/
股骨髁骨折	ggkgz/
跟骨骨髓炎	gggsy/
高弓足	ggz/
股骨颈骨折	ggjgz/
肱骨外科颈骨折	ggwkjgz/
股骨头坏死	ggths/
肱骨内上髁炎	ggnsky/
股后肌劳损	ghjls/
跟腱后滑囊炎	gjhhny/
跟骨骨刺综合征	gggczhz/
颌骨骨折	hggz/
喙突胸小肌综合征	htxxjzhz/
寰枢椎旋转脱位固定	hszxztwgd/
寰枢关节脱位	hsgjtw/
化脓性关节炎	hnxgjy/
颌骨造釉细胞瘤	hgzyxbl/
踝部骨折	hbgz/
踝关节扭伤	hgjns/
滑囊炎	hny/
滑膜肉瘤	hmrl/
横纹肌肉瘤	hwjrl/
褐黄病性关节炎	hhbxgjy/
颌面部骨巨细胞瘤	hmbgjxbl/
踝扭伤	hns/
间充质软骨肉瘤	jczrgrl/
假痛风性关节炎	jtfxgjy/
距骨骨折	jggz/
局限性骨脓肿	jxxgnz/
颈肋综合征	jlzhz/
肩-手综合征	j_szhz/
脊椎椎弓峡部裂	jzzgxbl/
脊椎结核后突畸形	jzjhhtjx/
脊椎结核并发截瘫	jzjhbfjt/
脊柱侧凸	jzct/
脊柱、脊髓损伤	jz_jsss/
脊髓空洞症	jskdz/
急性血源性骨髓炎	jxxyxgsy/
畸形性骨炎	jxxgy/
肌萎缩侧索硬化症	jwscsyhz/
急性腰扭伤	jxyns/
肩关节脱位	jgjtw/
脊椎结核寒性脓肿穿入空腔脏器	jzjhhxnzcrkqzq/
脊髓肿瘤	jszl/
距骨后外结节骨折	jghwjjgz/
肌张力异常	jzlyc/
痉挛性斜颈	jlxxj/
肌腱炎和腱鞘炎	jjyhjqy/
脊髓灰质炎	jshzy/
胫骨髁骨折	jgkgz/
胫骨内髁骨软骨病	jgnkgrgb/
胫骨结节骨软骨病	jgjjgrgb/
胫腓骨干骨折	jfgggz/
进行性脊髓性肌萎缩症	jxxjsxjwsz/
进行性骨干发育不全	jxxggfybq/
甲状旁腺骨营养不良	jzpxgyybl/
脊椎结核并发窦道	jzjhbfdd/
脊椎骨髓炎	jzgsy/
肌萎缩性侧索硬化	jwsxcsyh/
胫腓骨骨折	jfggz/
僵鉧	jm/
胫后神经痛	jhsjt/
眶底骨折	kdgz/
髋关节脱位	kgjtw/
髋关节结核	kgjjh/
肋锁综合征	lszhz/
梨状肌综合征	lzjzhz/
Maffucci综合征	maffuccizhz/
慢性化脓性骨髓炎	mxhnxgsy/
难产	nc/
颞骨骨折	nggz/
颞下颌关节脱位	nxhgjtw/
颞下颌关节强直	nxhgjqz/
颧骨骨折	qggz/
缺血性坏死	qxxhs/
屈肌腱损伤	qjjss/
前斜角肌综合征	qxjjzhz/
桡骨小头骨骺分离	rgxtghfl/
桡骨下端骨折	rgxdgz/
桡骨颈骨折	rgjgz/
桡骨、尺骨茎突骨折	rg_cgjtgz/
桡骨小头半脱位	rgxtbtw/
软骨肉瘤	rgrl/
软骨瘤	rgl/
软骨发育异常	rgfyyc/
软骨发育不全	rgfybq/
桡骨小头骨折	rgxtgz/
桡骨远端骨折	rgydgz/
松毛虫性骨关节病	smcxggjb/
锁骨骨折	sggz/
枢椎齿状突骨折	szcztgz/
神经性关节病	sjxgjb/
神经卡压综合征	sjkyzhz/
伸指肌腱损伤	szjjss/
少年性椎体骨软骨病	snxztgrgb/
色素绒毛结节性滑膜炎	ssrmjjxhmy/
同型胱氨酸尿症	txgasnz/
退变性关节病	tbxgjb/
听小骨创伤	txgcs/
特发性脊柱侧凸	tfxjzct/
透明细胞软骨肉瘤	tmxbrgrl/
维生素D缺乏性佝偻病	wssdqfxglb/
无脊髓损伤的颈椎骨折脱位	wjsssdjzgztw/
腕舟骨骨折	wzggz/
腕管综合征	wgzhz/
腕关节结核	wgjjh/
斜颈	xj/
先天性肘关节融合	xtxzgjrh/
先天性仰趾外翻足	xtxyzwfz/
先天性锁骨假关节	xtxsgjgj/
先天性马蹄内翻足	xtxmtnfz/
先天性髋脱位	xtxktw/
先天性髋内翻	xtxknf/
先天性胫骨假关节	xtxjgjgj/
先天性脊柱侧凸	xtxjzct/
先天性肌性斜颈	xtxjxxj/
先天性高肩胛症	xtxgjjz/
先天性尺桡骨融合	xtxcrgrh/
颈椎双侧关节突关节脱位	jzscgjtgjtw/
习惯性髌骨脱位	xgxbgtw/
膝关节结核	xgjjh/
先天性桡骨缺如	xtxrgqr/
胸椎结核椎旁脓肿穿入胸腔	xzjhzpnzcrxq/
先天性颅锁骨发育不全	xtxlsgfybq/
下背部痛	xbbt/
纤维肌痛症	xwjtz/
先天性椎体畸形	xtxztjx/
先天性外展性髋挛缩	xtxwzxkls/
先天性胫骨缺如	xtxjgqr/
先天性颈椎齿状突畸形	xtxjzcztjx/
先天性桡骨小头脱位	xtxrgxttw/
先天性多发性关节挛缩症	xtxdfxgjlsz/
先天性垂直距骨	xtxczjg/
系统性红斑狼疮性关节炎	xtxhblcxgjy/
膝关节创伤性滑膜炎	xgjcsxhmy/
膝关节半月板损伤	xgjbybss/
先天性肩关节脱位	xtxjgjtw/
旋转带肌腱炎	xzdjjy/
腰肌劳损	yjls/
月状骨骨软骨病	yzggrgb/
月骨脱位	ygtw/
腰部慢性劳损	ybmxls/
眼眶击出性骨折	ykjcxgz/
眼眶骨折	ykgz/
坐骨神经痛	zgsjt/
跖骨疲劳性骨折	zgplxgz/
灼性神经痛	zxsjt/
椎管内结核肉芽肿	zgnjhryz/
肘关节结核	zgjjh/
跖骨、趾骨骨折	zg_zggz/
掌指关节脱位	zzgjtw/
肘关节脱位	zgjtw/
肢骨纹状肥大	zgwzfd/
椎弓结核	zgjh/
趾间神经痛	zjsjt/
肘关节骨化肌炎	zgjghjy/
肘关节强直	zgjqz/
肘外翻	zwf/
足舟状骨骨软骨病	zzzggrgb/
姿态性腰腿痛	ztxytt/
周围性软骨肉瘤	zwxrgrl/
致密性髂骨炎	zmxqgy/
跖趾关节痛	zzgjt/
闭合性脑外伤	bhxnws/
鼻窦创伤	bdcs/
鼻疖	bj_2006/
鼻窦气压性创伤	bdqyxcs/
爆震性耳聋	bzxel/
创伤性溃疡	csxky/
尺神经损伤	csjss/
创伤性鼻中隔穿孔	csxbzgck/
创伤性鼻出血	csxbcx/
电击伤	djs_2015/
非冻结性冷伤	fdjxls/
腹部创伤	fbcs/
鼓膜外伤	gmws_2020/
喉部创伤	hbcs/
急性失血所致贫血	jxsxszpx/
急性单纯外伤性腰腿痛	jxdcwsxytt/
晶体脱位	jttw/
开放性脑外伤	kfxnws/
开放性手外伤	kfxsws/
慢性单纯外伤性腰腿痛	mxdcwsxytt/
脓性指头炎	nxzty/
气压创伤性中耳炎	qycsxzey/
强酸类中毒	qslzd/
梭状芽胞杆菌伤口感染	szybgjskgr/
头皮感染	tpgr/
头外伤	tws/
血胸	xx/
咽部机械性创伤	ybjxxcs/
腰腿痛	ytt/
咽喉部外伤	yhbws/
冻僵	dj/
电烧伤	dss/
化学烧伤	hxss/
热烧伤	rss/
应激性溃疡	yjxky/
烧伤感染	ssgr/
烧伤	ss/
烧伤休克	ssxk/
头皮及颅骨烧伤	tpjlgss/
小儿烧伤	xess/
咽喉烧伤及化学伤	yhssjhxs/
咽部灼伤	ybzs/
眼烧伤	yss/
鸡眼	jy/
疖	j/
皮肤囊肿	pfnz/
色素痣	ssz_2079/
痈	y/
鼻血管瘤	bxgl/
急性动脉栓塞	jxdmss/
脑动静脉畸形	ndjmjx/
四肢血管损伤	szxgss/
血管网织细胞瘤	xgwzxbl/
血管肉瘤	xgrl/
下肢深静脉血栓形成	xzsjmxsxc/
血管活性肠肽瘤	xghxctl/
拇指再造	mzzz/
柏哲病	bzb/
产褥期乳腺炎	crqrxy/
急性化脓性乳腺炎	jxhnxrxy/
乳腺囊性增生症	rxnxzsz/
乳房纤维腺瘤	rfxwxl/
乳腺结核	rxjh/
鼻咽癌	bya/
鼻咽肉瘤	byrl/
鼻咽血管纤维瘤	byxgxwl/
成纤维性纤维瘤	cxwxxwl/
单发性骨软骨瘤	dfxgrgl/
多发性遗传性骨软骨瘤	dfxycxgrgl/
多发性软骨瘤	dfxrgl/
恶性葡萄胎	exptt/
耳部恶性肿瘤	ebexzl/
血管内皮瘤	xgnpl/
恶性纤维组织细胞瘤	exxwzzxbl/
颞叶肿瘤	nyzl/
恶性黑色素瘤	exhssl/
腹膜后肿瘤	fmhzl/
非霍奇金淋巴瘤	fhqjlbl/
非骨化性纤维瘤	fghxxwl/
反分化软骨肉瘤	ffhrgrl/
非炎性单纯性突眼	fyxdcxty/
高泌乳素血症	gmrsxz/
宫颈癌	gja/
骨血管瘤	gxgl_2174/
骨外尤文氏瘤	gwywsl/
骨外骨肉瘤	gwgrl/
骨母细胞瘤	gmxbl/
骨膜性软骨瘤	gmxrgl/
骨化性纤维瘤	ghxxwl/
骨的恶性纤维组织细胞瘤	gdexxwzzxbl/
骨瘤	gl_2185/
睾丸肿瘤	gwzl/
颌面部神经纤维瘤	hmbsjxwl/
颌面部淋巴管瘤	hmblbgl/
喉癌	ha/
汗管瘤	hgl/
基底细胞瘤	jdxbl/
浆细胞瘤	jxbl/
脊索瘤	jsl/
甲状腺癌	jzxa/
颈部囊状淋巴管瘤	jbnzlbgl/
Kaposis肉瘤	kaposisrl/
卡波西肉瘤	kbxrl/
眶假瘤	kjl/
卵巢癌	lca/
良性葡萄胎	lxptt/
淋巴管肉瘤	lbgrl/
良性纤维组织细胞瘤	lxxwzzxbl/
淋巴管瘤	lbgl/
颅咽管瘤	lygl/
淋巴水肿	lbsz/
鳞状细胞癌	lzxba/
弥漫性恶性间皮瘤	mmxexjpl/
弥漫型间皮瘤	mmxjpl/
弥漫性血管内凝血	mmxxgnnx/
粘液表皮样癌	zybpya/
平滑骨肉瘤	phgrl/
皮肤癌	pfa/
葡萄膜恶性黑色素瘤	ptmexhssl/
乳管内乳头状瘤	rgnrtzl/
软腭癌	rea/
绒毛膜癌	rmma/
软骨粘液样纤维瘤	rgzyyxwl/
软骨母细胞瘤	rgmxbl/
乳头状囊腺瘤	rtznxl/
舌癌	sa_2261/
上颌窦癌	shda/
神经纤维肉瘤	sjxwrl/
上皮样肉瘤	spyrl/
神经瘤	sjl/
上颌窦恶性肿瘤	shdexzl/
筛窦恶性肿瘤	sdexzl/
视网膜母细胞瘤	swmmxbl/
听神经瘤	tsjl/
纹状骨瘤	wzgl/
外阴癌	wya/
网状细胞肉瘤	wzxbrl/
外耳道乳头状瘤	wedrtzl/
腺泡状软组织肉瘤	xpzrzzrl/
纤维肉瘤	xwrl/
涎腺癌	xxa/
纤维软骨间质瘤	xwrgjzl/
小肠肿瘤	xczl/
牙瘤	yl/
咽部脊索瘤	ybjsl/
咽部混合瘤	ybhhl/
原发性椎管内肿瘤	yfxzgnzl/
阴茎癌	yja/
硬纤维瘤	yxwl/
尤文氏肉瘤	ywsrl/
阴道恶性肿瘤	ydexzl/
眼眶肉瘤	ykrl/
咽畸胎瘤	yjtl/
牙龈癌	yya/
脂肪瘤	zfl/
子宫内膜癌	zgnma/
脂肪肉瘤	zfrl/
中耳癌	zea/
中心性软骨肉瘤	zxxrgrl/
枕叶肿瘤	zyzl/
阿米巴性阴道炎	ambxydy/
不孕症	byz/
处女膜闭锁	cnmbs/
滴虫性阴道炎	dcxydy/
单纯性外阴炎	dcxwyy/
附件炎	fjy/
非特异性阴道炎	ftyxydy/
宫外孕	gwy/
宫颈白斑	gjbb/
宫颈外翻	gjwf/
宫颈息肉	gjxr/
宫颈糜烂	gjml/
功血	gx/
更年期综合征	gnqzhz/
经前期综合征	jqqzhz/
急性子宫内膜炎	jxzgnmy/
急性宫颈炎	jxgjy/
老年性阴道炎	lnxydy/
卵巢囊肿	lcnz/
卵巢破裂	lcpl/
慢性宫颈炎	mxgjy/
霉菌性外阴炎	mjxwyy/
慢性子宫内膜炎	mxzgnmy/
慢性输卵管卵巢炎	mxslglcy/
盆腔炎	pqy/
葡萄胎	ptt_2381/
盆腔淤血综合征	pqyxzhz/
盆腔腹膜炎	pqfmy/
前置胎盘	qztp/
前庭大腺炎	qtdxy/
妊娠合并糖尿病	rshbtnb/
妊娠期心脏病	rsqxzb/
妊高征	rgz/
输卵管妊娠	slgrs/
生殖器念珠菌病	szqnzjb/
胎盘早剥	tpzb/
痛经	tj/
外阴瘙痒	wysy/
外阴白色病变	wybsbb/
外阴炎	wyy/
先天性无阴道	xtxwyd/
性交疼痛	xjtt/
幼女性外阴阴道炎	ynxwyydy/
月经不调	yjbd/
阴道痉挛	ydjl/
月经周期性精神病	yjzqxjsb/
阴道横隔	ydhg/
霉菌性阴道炎	mjxydy/
阴道毛滴虫病	ydmdcb/
子宫肥大	zgfd/
子宫肌瘤	zgjl/
子宫发育异常	zgfyyc/
子宫内膜异位症	zgnmywz/
子宫脱垂	zgtc/
子宫息肉	zgxr/
持续性枕后位、枕横位	cxxzhw_zhw/
产后出血	chcx/
多胎	dt/
过期妊娠	gqrs/
弓形虫病	gxcb/
流产	lc/
破水	ps/
脐带脱垂	qdtc/
妊娠合并肺结核	rshbfjh/
妊娠合并甲亢	rshbjk/
妊娠合并病毒性肝炎	rshbbdxgy/
臀先露	txl/
羊水栓塞	ysss/
子宫收缩过强	zgssgq/
子宫收缩乏力	zgssfl/
子宫破裂	zgpl/
早产	zc_2454/
早产儿	zce/
肠梨形鞭毛虫病	clxbmcb/
出血性休克和脑病综合征	cxxxkhnbzhz/
多种抽动综合征	dzcdzhz/
鹅口疮	ekc/
小儿多动症	xeddz/
儿童抽动障碍	etcdza/
儿童孤独症	etgdz/
儿童急性良性肌炎	etjxlxjy/
儿童期情绪障碍	etqqxza/
儿童精神分裂症	etjsflz/
过期产儿	gqce/
结节性硬化	jjxyh/
巨细胞病毒感染症	jxbbdgrz/
流行性腮腺炎	lxxsxy/
朗格汉斯细胞组织细胞增生症	lghsxbzzxbzsz/
母儿血型不合溶血病	mexxbhrxb/
母乳性黄疸	mrxhd/
奶癣	nx/
乳汁吸入性肺炎	rzxrxfy/
水杨酸类中毒	syslzd/
疝气	sq/
胎儿宫内窘迫	tegnjp/
维生素A中毒症	wssazdz/
维生素B1缺乏病	wssb1qfb/
维生素B6依赖综合征	wssb6ylzhz/
维生素A缺乏病	wssaqfb/
先天性全丙种球蛋白低下血症	xtxqbzqdbdxxz/
小儿肥胖	xefp/
新生儿泪囊炎	xselny/
小儿缺铁性贫血	xeqtxpx/
小儿营养不良	xeyybl/
新生儿脓疱病	xsenpb/
新生儿低钙血症	xsedgxz/
锌缺乏病	xqfb/
新生儿肝炎	xsegy/
小儿麻痹症	xembz/
新生儿黄疸	xsehd/
先天性声门下狭窄	xtxsmxxz/
先天性白内障	xtxbnz/
婴儿玫瑰疹	yemgz/
异位急性阑尾炎	ywjxlwy/
婴儿脐疝	yeqs/
婴儿手足搐搦症	yeszcnz/
婴幼儿腹泻	yyefx/
婴幼儿上颌骨骨髓炎	yyeshggsy/
婴儿骨皮质增生症	yegpzzsz/
幼年型类风湿病	ynxlfsb/
婴儿肠痉挛	yecjl/
牙体缺损	ytqs/
咽扁桃体肥大	ybttfd/
婴儿猝死综合征	yecszhz/
足月小样儿	zyxye/
自闭症	zbz/
智力低下	zldx/
早产儿视网膜病变	zceswmbb/
伴有虹膜睫状体炎的继发性青光眼	byhmjztydjfxqgy/
玻璃体猪囊虫病	bltzncb/
白内障	bnz/
玻璃体混浊	blthz/
瘢痕性类天疱疮	bhxltpc/
玻璃体出血	bltcx/
表层巩膜炎	bcgmy/
暴露性角膜炎	blxjmy/
包涵体性结膜炎	bhtxjmy/
春季性结膜炎	cjxjmy/
春季卡他性结膜炎	cjktxjmy/
蚕蚀性角膜溃疡	csxjmky/
低眼压性青光眼	dyyxqgy/
大泡性角膜病变	dpxjmbb/
单纯疱疹病毒性角膜炎	dcpzbdxjmy/
恶性青光眼	exqgy/
酚类中毒	flzd/
共同性外斜视	gtxwxs/
干燥性角结膜炎	gzxjjmy/
巩膜炎	gmy/
共同性斜视	gtxxs/
恒定性外斜视	hdxwxs/
红外线伤	hwxs/
化学性眼外伤	hxxyws/
化脓性葡萄膜炎	hnxptmy/
虹膜睫状体炎	hmjzty/
后天性视网膜劈裂	htxswmpl/
急性泪囊炎	jxlny/
近视眼	jsy/
角膜病	jmb/
间歇性外斜视	jxxwxs/
急性眼眶蜂窝织炎	jxykfwzy/
急性出血性结膜炎	jxcxxjmy/
睑板腺癌	jbxa/
晶体异位和脱位	jtywhtw/
结膜干燥症	jmgzz/
角膜擦伤	jmcs/
交感性眼炎	jgxyy/
急性卡他性结膜炎	jxktxjmy/
急性闭角性青光眼	jxbjxqgy/
睑外翻	jwf/
基质性角膜炎	jzxjmy/
角膜软化症	jmrhz/
急性虹膜睫状体炎	jxhmjzty/
眶上神经痛	kssjt/
眶蜂窝织炎	kfwzy/
开角型青光眼	kjxqgy/
泪腺分泌功能减退	lxfmgnjt/
泪液分泌过多	lyfmgd/
泪腺混合瘤	lxhhl/
淋菌性结膜炎	ljxjmy/
老年性黄斑变性	lnxhbbx/
流行性角结膜炎	lxxjjmy/
绿脓杆菌性角膜溃疡	lngjxjmky/
麦粒肿	mlz/
慢性泪腺炎	mxlxy/
脉络膜裂伤	mlmls/
麻痹性斜视	mbxxs/
脉络膜黑色素瘤	mlmhssl/
慢性泪囊炎	mxlny/
脉络膜炎	mlmy/
慢性闭角型青光眼	mxbjxqgy/
内隐斜	nyx/
泡性角结膜炎	pxjjmy/
匐行性角膜溃疡	fxxjmky/
泡性眼炎	pxyy/
青光眼	qgy/
缺血性视神经病变	qxxssjbb/
屈光不正	qgbz/
球后视神经炎	qhssjy/
青光眼睫状体炎综合征	qgyjztyzhz/
浅层点状角膜炎	qcdzjmy/
前房积血	qfjx/
缺血性视盘病变	qxxspbb/
弱视	rs/
上隐斜	syx/
沙眼	sy/
视网膜静脉阻塞	swmjmzs/
视网膜动脉阻塞	swmdmzs/
视网膜静脉周围炎	swmjmzwy/
视网膜病变	swmbb/
丝状角膜病变	szjmbb/
视网膜中央静脉阻塞	swmzyjmzs/
视网膜中央动脉阻塞	swmzydmzs/
视网膜色素上皮炎	swmssspy/
视盘炎	spy/
视网膜色素变性	swmssbx/
视网膜脱离	swmtl/
视盘水肿	spsz/
视交叉病变	sjcbb/
上睑下垂	sjxc/
特发性葡萄膜大脑炎	tfxptmdny/
外层渗出性视网膜病变	wcscxswmbb/
外隐斜	wyx/
外伤性白内障	wsxbnz/
雪盲	xm/
旋转隐斜	xzyx/
霰粒肿	xlz/
先天性视网膜劈裂	xtxswmpl/
细菌性角膜溃疡	xjxjmky/
先天性青光眼	xtxqgy/
溢泪症	ylz/
隐斜视	yxs/
眼眶骨膜炎	ykgmy/
原发性共同性内斜视	yfxgtxnxs/
原发性非调节性内斜视	yfxfdjxnxs/
原发性开角型青光眼	yfxkjxqgy/
眼眶假瘤	ykjl/
远视眼	ysy/
原发性视网膜脱离	yfxswmtl/
眼球突出	yqtc/
眼球穿通伤	yqcts/
眼内异物	ynyw/
眼部带状疱疹	ybdzpz/
眼睑皮肤弛缓症	yjpfchz/
眼睑带状疱疹	yjdzpz/
圆锥角膜	yzjm/
原发性视网膜色素变性	yfxswmssbx/
眼球震颤	yqzc/
眼球破裂伤	yqpls/
眼球内陷	yqnx/
眼睑湿疹	yjsz/
翼状胬肉	yznr/
紫外线伤	zwxs/
中心性渗出性脉络膜视网膜炎	zxxscxmlmswmy/
真菌性角膜溃疡	zjxjmky/
中心性浆液性脉络膜视网膜病变	zxxjyxmlmswmbb/
中毒性弱视	zdxrs/
周边葡萄膜炎	zbptmy/
真菌性角膜炎	zjxjmy/
阿斯匹林不耐受三联症	asplbnsslz/
鼻硬结病	byjb/
鼻出血	bcx/
鼻腔异物	bqyw/
鼻息肉	bxr/
鼻中隔偏曲	bzgpq/
鼻中隔血肿	bzgxz/
鼻中隔穿孔	bzgck/
扁桃体周围脓肿	bttzwnz/
鼻前庭炎	bqty/
鼻中隔溃疡	bzgky/
鼻石	bs/
鼻瓣区狭窄	bbqxz/
病毒性咽炎	bdxyy/
鼻窦炎	bdy/
鼻恶性肉芽肿	bexryz/
白喉	bh/
大疱性鼓膜炎	dpxgmy/
耳源性脑膜炎	eyxnmy/
耳后骨膜下脓肿	ehgmxnz/
腭咽闭合不全	eybhbq/
分泌性中耳炎	fmxzey/
过敏性鼻炎	gmxby/
干酪性鼻炎	glxby/
鼓室硬化症	gsyhz/
过强反射性鼻炎	gqfsxby/
颌骨骨髓炎	hggsy/
化脓性耳廓软骨膜炎	hnxekrgmy/
喉阻塞	hzs/
喉气囊肿	hqnz/
急性扁桃体炎	jxbtty/
茎突综合征	jtzhz/
间断脉冲噪音损伤	jdmczyss/
甲状舌囊肿及瘘管	jzsnzjlg/
急性舌扁桃体炎	jxsbtty/
急性化脓性乳突炎	jxhnxrty/
急性单纯性咽炎	jxdcxyy/
急性鼻咽炎	jxbyy/
急性化脓性中耳炎	jxhnxzey/
急性化脓性鼻窦炎	jxhnxbdy/
急性会厌炎	jxhyy/
急性喉炎	jxhy/
急性鼻炎	jxby/
结核性中耳乳突炎	jhxzerty/
酒渣鼻	jzb_2846/
口咽部粘连	kybzl/
蓝鼓膜与胆固醇肉芽肿	lgmydgcryz/
链球菌性咽炎	lqjxyy/
粒性白细胞缺乏性咽峡炎	lxbxbqfxyxy/
面肌痉挛	mjjl/
迷路炎	mly/
美尼尔氏综合症	mneszhz/
迷路震荡	mlzd/
迷路窗破裂	mlcpl/
弥漫性外耳道炎	mmxwedy/
慢性舌扁桃体炎	mxsbtty/
慢性额窦炎	mxedy/
慢性蝶窦炎	mxddy/
慢性单纯性咽炎	mxdcxyy/
慢性化脓性中耳炎	mxhnxzey/
慢性扁桃体炎	mxbtty/
慢性喉炎	mxhy/
慢性肥厚性鼻炎	mxfhxby/
慢性单纯性鼻炎	mxdcxby/
慢性咽炎	mxyy/
面神经瘤	msjl/
粘连性中耳炎	zlxzey/
潜水性内耳损伤	qsxness/
气管及食管异物	qgjsgyw/
嗜酸细胞增多性非变态反应性鼻炎	ssxbzdxfbtfyxby/
上颌窦后鼻孔息肉	shdhbkxr/
鳃裂瘘管	sllg/
腮腺隙感染	sxxgr/
突发性聋	tfxl/
外耳道异物	wedyw/
萎缩性咽炎	wsxyy/
外耳道疖肿	wedjz/
萎缩性鼻炎	wsxby/
外耳道真菌病	wedzjb/
外耳道炎	wedy/
外耳湿疹	wesz/
先天性声带发育不良	xtxsdfybl/
悬雍垂过长症	xycgcz/
先天性小喉	xtxxh/
先天性后鼻孔闭锁	xtxhbkbs/
先天性喉蹼	xtxhp/
先天性喉喘鸣	xtxhcm/
先天性鼻咽部狭窄及闭锁	xtxbybxzjbs/
先天性鼻部皮样囊肿及瘘管	xtxbbpynzjlg/
先天性喉闭锁	xtxhbs/
咽部异感症	ybygz/
硬脑膜外和硬脑膜下脓肿	ynmwhynmxnz/
咽血管畸形	yxgjx/
咽肌痉挛	yjjl/
咽后壁憩室	yhbqs/
咽鼓管阻塞	yggzs/
咽鼓管异常开放症	yggyckfz/
咽侧壁憩室	ycbqs/
咽部硬结病	ybyjb/
咽部异物	ybyw/
咽部麻风	ybmf/
咽部狼疮	yblc/
咽部创伤	ybcs/
咽部瘢痕狭窄	ybbhxz/
咽角化症	yjhz/
咽后脓肿	yhnz/
咽旁脓肿	ypnz/
咽白喉	ybh/
中耳气压伤	zeqys/
噪声性耳聋	zsxel/
中毒性眩晕	zdxxy/
扁平苔癣	bptx/
边缘性龈炎	byxyy/
变应性口炎	byxky/
唇裂	cl/
创伤性口炎	csxky_2951/
唇病	cb/
齿状突发育畸形	cztfyjx/
多形红斑	dxhb/
单纯性牙周炎	dcxyzy/
腭裂	el/
肥大性龈炎	fdxyy/
氟骨症	fgz/
氟牙症	fyz/
根尖周病	gjzb/
红斑	hb/
坏死性龈口炎	hsxyky/
颌面部放线菌病	hmbfxjb/
颌周蜂窝织炎	hzfwzy/
颌骨囊肿	hgnz/
后牙反合	hyfh/
颌骨癌	hga/
急性颌骨骨髓炎	jxhggsy/
甲状舌管囊肿与鳃裂囊肿	jzsgnzyslnz/
急性化脓性腮腺炎	jxhnxsxy/
颊间隙感染	jjxgr/
结核性溃疡	jhxky/
口底多间隙感染	kddjxgr/
口腔溃疡	kqky/
口腔扁平苔藓	kqbptx/
口腔单纯性疱疹	kqdcxpz/
口腔白斑病	kqbbb/
口腔念珠菌病	kqnzjb/
颏下间隙感染	kxjxgr/
眶下间隙感染	kxjxgr_2992/
开合	kh/
口腔颌面部皮样、表皮样囊肿	kqhmbpy_bpynz/
口腔颌面部软组织损伤	kqhmbrzzss/
膜性口炎	mxky/
磨损	ms/
毛舌	ms_3000/
慢性上颌窦炎	mxshdy/
慢性筛窦炎	mxsdy/
慢性化脓性腮腺炎	mxhnxsxy/
颞下颌关节紊乱综合征	nxhgjwlzhz/
颞下间隙感染	nxjxgr/
颞间隙感染	njxgr/
颞骨岩部炎	ngyby/
前牙反合	qyfh/
青少年牙周炎	qsnyzy/
龋齿	qc/
前牙深覆盖	qysfg/
舌甲状腺	sjzx/
舌白斑	sbb/
锁合	sh/
双颌前突	shqt/
深覆合	sfh/
舌下间隙感染	sxjxgr/
上颌前突	shqt_3027/
舌病	sb/
四环素牙	shsy/
上颌后缩	shhs/
天疱疮	tpc/
楔状缺损	xzqs/
下颌后缩	xhhs/
下颌下隙感染	xhxxgr/
牙周病	yzb/
牙周萎缩	yzws/
牙外伤	yws/
牙列拥挤	ylyj/
牙列稀疏	ylxs/
牙髓病	ysb/
颜面部疖痈	ymbjy/
牙隐裂	yyl/
牙折	yz/
遗传性乳光牙	ycxrgy/
药物性牙龈增生	ywxyyzs/
釉质发育不全	yzfybq/
牙齿感觉过敏症	ycgjgmz/
咬肌间隙感染	yjjxgr/
翼下颌间隙感染	yxhjxgr/
智齿冠周炎	zcgzy/
肝硬化男性性功能减弱综合征	gyhnxxgnjrzhz/
淋病合并症前列腺炎	lbhbzqlxy/
淋病合并症精囊炎	lbhbzjny/
良性前列腺增生	lxqlxzs/
慢性细菌性前列腺炎	mxxjxqlxy/
男性不育症	nxbyz/
男性更年期综合症	nxgnqzhz/
尿道与阴茎结核	ndyyjjh/
性欲亢进	xykj/
小阴茎	xyj/
阳痿	yw/
早泄	zx/
埃里希体病	alxtb/
艾滋病	azb/
病毒性肝炎	bdxgy/
包虫病	bcb_3114/
巴尔通体病	bettb/
布氏杆菌病	bsgjb/
布鲁菌病	bljb/
孢子丝菌病	bzsjb/
肠道蛔虫	cdhc/
传染性脓疱病	crxnpb/
传染性红斑	crxhb/
传染性软疣	crxry/
传染性单核细胞增多	crxdhxbzd/
传染性湿疹样皮炎	crxszypy/
单纯性疱疹	dcxpz/
带状疱疹	dzpz/
地方性斑疹伤寒	dfxbzsh/
登革热	dgr/
单纯疱疹病毒感染症	dcpzbdgrz/
丹毒丝菌病	ddsjb/
二期梅毒	eqmd/
放线菌病	fxjb/
副球孢子菌病	fqbzjb/
风疹	fz/
肺结核	fjh/
肺吸虫病	fxcb/
钩端螺旋体病	gdlxtb/
回归热	hgr/
混合性厌氧菌感染	hhxyyjgr/
黄热病	hrb/
黑热病	hrb_3163/
霍乱	hl_3165/
假单胞菌感染	jdbjgr/
姜片虫病	jpcb/
尖锐湿疣	jrsy/
柯萨奇病毒和埃可病毒感染	ksqbdhakbdgr/
狂犬病	kqb/
口蹄病	ktb/
淋病	lb/
利斯特菌病	lstjb/
类鼻疽	lbj/
流行性脑脊髓膜炎	lxxnjsmy/
流行性乙型脑炎	lxxyxny/
流行性斑疹伤寒	lxxbzsh/
莱姆病	lmb/
慢性腹泻	mxfx/
脑血吸虫病	nxxcb/
囊虫病	ncb_3214/
疟疾	nj/
诺卡放线菌病	nkfxjb/
皮肤念珠菌病	pfnzjb/
葡萄球菌感染	ptqjgr/
全身性念珠菌病	qsxnzjb/
潜伏梅毒	qfmd/
Q热	qr/
肉毒中毒	rdzd/
溶组织内阿米巴病	rzznambb/
软下疳	rxg/
生殖器疱疹	szqpz/
伤寒	sh_3237/
三期梅毒	sqmd/
丝虫病	scb/
伤寒与副伤寒	shyfsh/
水痘	sd/
鼠疫	sy_3246/
绦虫病	tcb/
天花	th/
炭疽病	tjb/
头癣	tx/
兔热病	trb/
弯曲菌感染	wqjgr/
弯曲菌性肠炎	wqjxcy/
先天性巨细胞包涵体病	xtxjxbbhtb/
血吸虫病	xxcb/
猩红热	xhr/
旋毛虫病	xmcb/
新疆出血热	xjcxr/
衣原体感染症	yytgrz/
厌氧菌感染	yyjgr/
隐球菌病	yqjb/
芽生菌病	ysjb/
异尖线吸虫蚴移行症	yjxxcyyxz/
阴虱病	ysb_3281/
一期梅毒	yqmd/
医院内感染	yyngr/
恙虫病	ycb/
羊痘	yd/
隐孢子虫病	ybzcb/
组织胞浆菌病	zzbjjb/
中间型链球菌感染	zjxlqjgr/
着色真菌病	zszjb/
足菌肿	zjz/
战壕热	zhr/
真菌过敏症	zjgmz/
自由生活阿米巴感染	zyshambgr/
志贺菌病	zhjb/
剥脱性皮炎型药疹	btxpyxyz/
扁平疣	bpy/
白癜风	bdf/
白发症	bfz/
斑秃	bt/
藏毛囊肿	cmnz/
痤疮	cc/
大疱性类天疱疮	dpxltpc/
丹毒	dd/
多形性日光疹	dxxrgz/
冻疮	dc/
鹅掌风	ezf/
蜂螫伤	fss_3332/
蜂窝织炎	fwzy/
痱子	fz_3334/
副牛痘	fnd/
光感型药疹	ggxyz/
固定性药疹	gdxyz/
花斑癣	hbx/
黄褐斑	hhb/
核黄素缺乏病	hhsqfb/
结核性苔藓	jhxtx/
急性脓肿	jxnz/
甲癣	jx_3349/
甲沟炎	jgy/
接触性皮炎	jcxpy/
疥疮	jc/
毛发红糠疹	mfhkz/
毛发上皮瘤	mfspl/
面部粟粒性狼疮	mbslxlc/
麻疹样红斑型药疹	mzyhbxyz/
玫瑰糠疹	mgkz/
毛囊炎	mny/
麻风病	mfb/
麻疹	mz/
女子颜面黑变病	nzymhbb/
脓肿	nz_3369/
脓疱疮	npc/
牛皮癣	npx/
皮样囊肿	pynz/
葡萄球菌性烫伤样皮肤综合征	ptqjxtsypfzhz/
疱疹样湿疹	pzysz/
全身化脓性感染	qshnxgr/
褥疮	rc/
神经性皮炎	sjxpy/
瘙痒症	syz/
晒伤	ss_3395/
手足癣	szx/
湿疹	sz/
深脓疱病	snpb/
色素性荨麻疹	ssxqmz/
秃头	tt_3406/
荨麻疹型药疹	qmzxyz/
荨麻疹和血管性水肿	qmzhxgxsz/
荨麻疹性血管炎	qmzxxgy/
荨麻疹	qmz/
银屑病	yxb/
药疹	yz_3418/
疣	y_3419/
原发性皮肤淀粉样变性	yfxpfdfybx/
痒疹	yz_3426/
硬红斑	yhb/
脂溢性皮炎	zyxpy/
职业黑变病	zyhbb/
中毒性坏死性表皮松解型药疹	zdxhsxbpsjxyz/
着色芽生菌病和暗色丝孢霉病	zsysjbhassbmb/
腹股沟肉芽肿	fggryz/
梅毒	md/
性病性淋巴肉芽肿	xbxlbryz/
阿尔采末病	aecmb/
阿斯伯格综合症	asbgzhz/
抽动障碍	cdza/
多发脑梗塞性精神障碍	dfngsxjsza/
癫痫伴发的精神障碍	dxbfdjsza/
儿童期精神障碍及精神发育迟缓	etqjszajjsfych/
反应性精神病	fyxjsb/
精神活性物质所致精神障碍	jshxwzszjsza/
急性应激反应	jxyjfy/
焦虑症	jlz/
记忆障碍	jyza/
精神发育迟滞	jsfycz/
精神分裂症	jsflz/
酒精所致精神障碍	jjszjsza/
甲状腺功能减退伴发的精神障碍	jzxgnjtbfdjsza/
恐缩症	ksz/
窥阴癖	kyp/
恐怖性焦虑障碍	kbxjlza/
恐怖症	kbz/
恋物癖	lwp/
露阴癖	lyp/
老年期抑郁障碍	lnqyyza/
脑外伤所致精神障碍	nwsszjsza/
偏执性精神障碍	pzxjsza/
气功所致精神障碍	qgszjsza/
情感障碍	qgza/
强迫症	qpz/
强迫性障碍	qpxza/
躯体疾病伴发的精神障碍	qtjbbfdjsza/
人格障碍	rgza/
神经发育迟滞	sjfycz/
失眠症	smz/
神经性厌食症	sjxysz/
嗜睡症	ssz_3486/
系统性红斑狼疮所致精神病	xtxhblcszjsb/
性障碍	xza/
性欲减退	xyjt/
遗忘综合征	ywzhz/
应激反应及适应障碍	yjfyjsyza/
抑郁症	yyz/
抑郁性神经症	yyxsjz/
异性装扮癖	yxzbp/
癔球症	yqz/
癔症	yz_3499/
疑病症	ybz/
谵妄综合征及有关疾病	zwzhzjygjb/
苯丙胺中毒	bbazd/
苯海拉明中毒	bhlmzd/
颠茄碱类植物药物中毒	dqjlzwywzd/
毒蛇咬伤	dsys/
对乙酰氨基酚中毒	dyxajfzd/
II型肾小管性酸中毒	iixsxgxszd/
高原适应不全症	gysybqz/
河豚毒素中毒	htdszd/
急性硫化氢中毒	jxlhqzd/
麻黄碱中毒	mhjzd/
马桑果中毒	msgzd/
曼陀罗中毒	mtlzd/
锰中毒	mzd/
灭虫灵中毒	mclzd/
木薯中毒	mszd/
慢性铅中毒	mxqzd/
棉子中毒	mzzd/
拟除虫菊类农药中毒	nccjlnyzd/
体温过低	twgd/
中暑痉挛	zsjl/
中毒性休克综合征	zdxxkzhz/
病毒性肺炎	bdxfy/
疱疹性咽峡炎	pzxyxy/
新生儿肺炎	xsefy/
煤气中毒	mqzd/
肺动静脉瘤	fdjml_3674/
胆囊息肉	dnxr/
放射病	fsb/
非酒精性脂肪肝病	fjjxzfgb/
壶腹周围癌	hfzwa/
黄曲霉素中毒	hqmszd/
十二指肠损伤	sezcss/
十二指肠淤积症	sezcyjz_3681/
特发性胃肠道嗜酸性细胞浸润综合征	tfxwcdssxxbjrzhz/
萎缩性胃炎	wsxwy/
挤压综合征	jyzhz/
尿毒症	ndz/
肾结石	sjs_3686/
肾移植	syz_3687/
先天性肾上腺皮质增生症	xtxssxpzzsz/
癫痫	dx/
多发梗塞性痴呆	dfgsxcd/
红斑性肢痛症	hbxztz/
进行性延髓麻痹	jxxysmb/
三叉神经痛	scsjt/
多毛症	dmz/
戈谢病	gxb_3695/
巨人症	jrz/
淋巴瘤	lbl/
慢性肾上腺皮质功能减退症	mxssxpzgnjtz/
糖原累积病	tyljb/
性早熟	xzs/
胰岛功能性β细胞瘤	ydgnxxbl/
急性骨髓性白血病	jxgsxbxb/
气性坏疽病	qxhjb/
纤维肌痛综合症	xwjtzhz/
弓形体脑病	gxtnb/
胶质细胞瘤	jzxbl/
眶脑膜瘤	knml/
脑瘤	nl_3708/
脑栓塞	nss/
小脑扁桃体下疝	xnbttxs/
输精管堵塞	sjgds/
睾丸下降不全	gwxjbq/
肛膜闭锁	gmbs_3713/
先天性肛门直肠狭窄	xtxgmzcxz/
肱骨外髁颈骨折	ggwkjgz_3715/
骨质增生	gzzs/
桡骨干下1/3骨折合并下尺桡关节脱位	rggx1_3gzhbxcrgjtw/
桡神经损伤	rsjss/
十字韧带损伤	szrdss/
手部肌腱损伤	sbjjss/
腕舟状骨骨折	wzzggz/
膝关节侧副韧带损伤	xgjcfrdss/
眼球穿孔伤	yqcks/
断肢再植	dzzz_3724/
腹壁切口疝	fbqks/
腹膜后脓肿	fmhnz/
腹腔脓肿	fqnz/
股疝	gs_3728/
慢性阑尾炎	mxlwy/
肛门周围癌	gmzwa/
黑色素瘤	hssl/
口腔癌	kqa/
腮腺混合瘤	sxhhl/
神经纤维瘤	sjxwl/
星形细胞瘤	xxxbl/
咽部乳头状瘤	ybrtzl/
眼内转移性肿瘤	ynzyxzl/
滴虫性外阴炎	dcxwyy_3738/
卵巢早衰	lczs/
细菌性阴道炎	xjxydy/
羊水过少	ysgs/
急性播散性脑脊髓炎	jxbsxnjsy/
巨大儿	jde/
尿布疹	nbz_3744/
手足口病	szkb/
小儿高热	xegr/
小儿急性阑尾炎	xejxlwy/
小儿惊厥	xejj/
支原体感染	zytgr/
红眼病	hyb/
急性泪腺炎	jxlxy/
色盲	sm/
鼻中隔脓肿	bzgnz/
耵聍栓塞	dnss/
耳聋	el_3755/
喉气管瘢痕性狭窄	hqgbhxxz/
甲状舌骨囊肿与瘘	jzsgnzyl/
慢性鼻炎	mxby/
慢性干燥性鼻炎	mxgzxby/
声带息肉	sdxr/
突发性耳聋	tfxel/
先天性耳聋	xtxel/
先天性喉裂	xtxhl/
咽部结核	ybjh/
咽旁间隙感染	ypjxgr/
咽异感症	yygz/
地图舌	dts/
颌下间隙感染	hxjxgr/
舌下腺囊肿	sxxnz/
包茎过长	bjgc/
包皮过长	bpgc/
不射精症	bsjz/
睾丸炎	gwy_3773/
精囊炎	jny/
男性生殖器畸形	nxszqjx/
男性生殖器外伤	nxszqws/
少精子症	sjzz/
死精症	sjz_3778/
无精症	wjz/
阴囊湿疹	ynsz/
肝吸虫病	gxcb_3781/
巨细胞病毒感染	jxbbdgr/
森林脑炎	slny/
瘢痕疙瘩	bhgd/
剥脱性角质松解症	btxjzsjz/
虫咬皮炎	cypy/
单纯糠疹	dckz/
多汗症	dhz/
红皮病	hpb/
灰指甲	hzj/
肌注硬结感染	jzyjgr/
激素依赖性皮炎	jsylxpy/
急性蜂窝组织炎	jxfwzzy/
甲营养不良	jyybl/
脚气	jq/
结节性红斑	jjxhb/
立克次体病	lkctb/
连续性肢端皮炎	lxxzdpy/
人蠕形螨病	rrxmb/
色素紫癜性皮炎	sszdxpy/
手足皲裂	szjl/
太田痣	ttz/
脱发	tf_3803/
药物性皮炎	ywxpy/
腋臭	yc/
异位性皮炎	ywxpy_3806/
疣状表皮发育不良	yzbpfybl/
鱼鳞病	ylb/
跖疣	zy/
性高潮障碍	xgcza/
分裂情感性精神病	flqgxjsb/
甲状腺功能亢进伴发的精神障碍	jzxgnkjbfdjsza/
旅途精神病	ltjsb/
神经性贪食症	sjxtsz/
妄想症	wxz/
性兴奋障碍	xxfza/
性冷淡	xld/
谵妄综合征	zwzhz/
中暑	zs/
甲型H1N1流感(猪流感)	jxh1n1lg_zlg_/
鼻/鼻型T/NK细胞淋巴瘤	b_bxt_nkxblbl/
大咯血	dkx/
单纯性肺嗜酸性粒细胞浸润症	dcxfssxlxbjrz/
感染性腹主动脉瘤	grxfzdml/
弯曲菌肠炎	wqjcy/
新生儿中毒性红斑	xsezdxhb/
小儿多发性内分泌腺瘤Ⅱ型	xedfxnfmxl_x/
小儿肥胖通气不良综合征	xefptqblzhz/
心源性休克	xyxxk/
氨基酸代谢病	ajsdxb/
B链球菌群感染	blqjqgr/
巴斯德菌肺炎	bsdjfy/
半月板损伤	bybss/
扁平苔藓	bptx_3834/
便血	bx/
肠病原性大肠埃希杆菌感染	cbyxdcaxgjgr/
肠气囊肿	cqnz/
肠侵袭性大肠埃希杆菌感染	cqxxdcaxgjgr/
肠系膜上动脉综合征	cxmsdmzhz/
肠系膜上动脉血栓形成	cxmsdmxsxc/
大网膜粘连综合征	dwmzlzhz/
第一掌骨基部骨折	dyzgjbgz/
多发性一过性白点综合征	dfxygxbdzhz/
小儿热带嗜酸性粒细胞增多症	xerdssxlxbzdz/
常现丝虫病	cxscb/
膀胱鳞状细胞癌	bglzxba/
丛状血管瘤	czxgl/
多发性硬化伴发的葡萄膜炎	dfxyhbfdptmy/
多发内生软骨瘤病	dfnsrglb/
大肠埃希杆菌肺炎	dcaxgjfy/
单纯性乳腺增生症	dcxrxzsz/
低血糖综合征	dxtzhz/
盖氏骨折	gsgz/
慢性淋巴细胞白血病	mxlbxbbxb/
白细胞葡萄糖-6-磷酸脱氢酶缺乏症	bxbptt_6_lstqmqfz/
白塞病伴发的精神障碍	bsbbfdjsza/
迟发性皮肤卟啉病	cfxpfblb/
淀粉样变病的胃肠道表现	dfybbdwcdbx/
高尿酸血症肾病	gnsxzsb/
食物过敏性哮喘	swgmxxc/
薄肾小球基底膜病	bsxqjdmb/
创伤性心源性溶血性贫血	csxxyxrxxpx/
短膜壳绦虫病	dmktcb/
胆石性肠梗阻	dsxcgz/
穿透性角膜移植术所致青光眼	ctxjmyzsszqgy/
腹股沟直疝	fggzs/
髌腱断裂	bjdl/
髌骨不稳定	bgbwd/
鼻红粒病	bhlb/
尺桡骨骨干双骨折	crgggsgz/
成人T细胞白血病	crtxbbxb/
创伤窒息综合征	cszxzhz/
尺管综合征	cgzhz/
对苯二胺皮炎	dbeapy/
点状内层脉络膜病变	dzncmlmbb/
单侧肾缺如	dcsqr/
骶尾部畸胎瘤	dwbjtl/
脊柱脊髓伤	jzjss/
泄殖腔外翻	xzqwf/
先天性毛细血管扩张性大理石样皮肤	xtxmxxgkzxdlsypf/
先天性高位肩胛	xtxgwjj/
先天自愈性朗格汉斯组织细胞增生症	xtzyxlghszzxbzsz/
先天性结肠狭窄和闭锁	xtxjcxzhbs/
鼻窦鳞状细胞癌的眼部病变	bdlzxbadybbb/
创伤性气管及主支气管损伤	csxqgjzzqgss/
创伤性膈疝	csxgs/
冻伤	ds/
败血症	bxz/
痴呆	cd/
单发性毛鞘瘤	dfxmql/
高免疫球蛋白E综合征	gmyqdbezhz/
汞皮炎	gpy/
持续性枕后位难产	cxxzhwnc/
支原体尿路感染	zytnlgr/
伴有脂肪瘤样痣的褶皱皮肤	byzflyzdzzpf/
玻璃纤维引起的皮肤病	blxwyqdpfb/
玻璃体积血	bltjx/
爆裂性眼眶骨折	blxykgz/
大疱性表皮松解	dpxbpsj/
鼻孢子虫病	bbzcb/
白喉性心肌炎	bhxxjy/
全面性发作	qmxfz/
灼痛	zt/
双胎妊娠	strs/
舌骨骨折	sggz_3905/
不随意运动	bsyyd/
巴雷特食管	bltsg/
丹吉尔病	djeb/
单纯疱疹	dcpz/
大网膜囊肿	dwmnz_3910/
藏毛性疾病	cmxjb/
抽搐与惊厥	ccyjj/
路易体痴呆	lytcd/
额颞痴呆	encd/
盆底综合征	pdzhz/
脱发性毛囊炎	tfxmny/
丑胎	ct/
多发脑梗死性痴呆	dfngsxcd/
焦油性黑变病	jyxhbb/
继发性白血病	jfxbxb/
口臭	kc/
脑型肺吸虫病	nxfxcb/
神经根型颈椎病	sjgxjzb/
神经性厌食症与神经性贪食症	sjxyszysjxtsz/
微病毒B19感染性风湿病	wbdb19grxfsb/
胸、腰椎爆裂骨折	x_yzblgz/
毒性结节性甲状腺肿	dxjjxjzxz/
钝挫伤	dcs/
分裂情感性障碍	flqgxza/
多肌腱末端病	djjmdb/
多毛状小阴唇	dmzxyc/
多重肺部感染	dzfbgr/
恶性雀斑样痣	exqbyz/
恶性小汗腺汗孔瘤	exxhxhkl/
鄂木斯克出血热	emskcxr/
颚口线虫病	ekxcb/
耳鼻咽喉创伤	ebyhcs/
分水岭区脑梗死	fslqngs/
二糖酶缺乏症	etmqfz/
Fuchs角膜内皮营养不良	fuchsjmnpyybl/
反应性组织细胞增多症	fyxzzxbzdz/
非淋球菌性细菌性关节炎	flqjxxjxgjy/
非特异性系统性坏死性小血管炎	ftyxxtxhsxxxgy/
肥大性骨关节病	fdxggjb/
粉刺样痣	fcyz/
风湿病性贫血	fsbxpx/
腹壁纤维肉瘤	fbxwrl/
腹部大血管损伤	fbdxgss/
腹膜后纤维化	fmhxwh/
腹膜转移癌	fmzya/
腹腔肺吸虫病	fqfxcb/
高胡萝卜素血症	ghlbsxz/
革兰阳性球菌和革兰阴性杆菌性巩膜炎	glyxqjhglyxgjxgmy/
格斯特曼综合征	gstmzhz/
跟骨骨骺骨软骨病	ggghgrgb/
更年期角化症	gnqjhz/
肱骨上端骨骺分离	ggsdghfl/
阿米巴痢疾	amblj/
股骨髁上骨折	ggksgz_3959/
股骨头骨折	ggtgz/
股骨转子间骨折	ggzzjgz/
股神经干性痛	gsjgxt/
骨产道异常性难产	gcdycxnc/
骨恶性淋巴瘤	gexlbl/
骨骺点状发育不良	ghdzfybl/
骨良性纤维组织细胞瘤	glxxwzzxbl/
骨膜软骨瘤	gmrgl/
骨纤维肉瘤	gxwrl/
骨纤维异样增殖症	gxwyyzzz/
骨血管内皮细胞瘤	gxgnpxbl/
固定性斜视	gdxxs/
腘血管陷迫综合征	gxgxpzhz/
寒冷性红斑	hlxhb/
汗孔角化病	hkjhb/
黑布拉痒疹	hblyz/
红细胞生成性卟啉病	hxbscxblb/
虹膜黑色素瘤	hmhssl/
喉气管食管裂	hqgsgl/
后葡萄膜炎	hptmy/
厚皮性骨膜病	hpxgmb/
呼吸肌疲劳症	hxjplz/
忽略症	hlz/
滑石粉尘肺	hsfcf/
化学液体吸入	hxytxr/
踝关节软骨损伤	hgjrgss/
坏疽性脓皮症	hjxnpz/
寰枢椎脱位	hsztw/
寰椎沟环畸形	hzghjx/
埃莱尔-当洛综合征	ale_dlzhz/
会阴疝	hys/
惠普尔病	hpeb/
火激红斑	hjhb/
获得性循环抗凝物质增多症	hdxxhknwzzdz/
肌肉肌腱单位的急性损伤	jrjjdwdjxss/
肌张力障碍综合征	jzlzazhz/
积乳囊肿	jrnz/
基底细胞癌	jdxba/
吉特林综合征	jtlzhz/
急性横贯性脊髓炎	jxhgxjsy/
急性化脓性脑膜炎	jxhnxnmy/
急性化脓性胃炎	jxhnxwy/
急性酒中毒	jxjzd/
急性粒细胞缺乏	jxlxbqf/
急性淋巴细胞白血病	jxlbxbbxb/
急性咽炎	jxyy/
急性硬脑膜下血肿	jxynmxxz/
脊髓分裂症	jsflz_4007/
脊椎化脓性骨髓炎	jzhnxgsy/
假麦格综合征	jmgzhz/
假性肠梗阻	jxcgz/
肩峰下滑囊炎	jfxhny/
肩关节周围炎	jgjzwy/
肩锁关节脱位	jsgjtw/
埃可病毒疹	akbdz/
腱病	jb/
浆细胞白血病	jxbbxb/
浆细胞性唇炎	jxbxcy/
胶样粟丘疹	jysqz/
角膜基质炎	jmjzy/
结缔组织痣	jdzzz/
结节性甲状腺肿	jjxjzxz/
进行性核上性麻痹	jxxhsxmb/
晶状体蛋白过敏性青光眼	jztdbgmxqgy/
精索恶性肿瘤	jsexzl/
颈部火器性异物	jbhqxyw/
颈淋巴结结核	jlbjjh/
颈椎半椎体畸形	jzbztjx/
颈椎间盘突出症	jzjptcz/
颈椎椎管狭窄症	jzzgxzz/
胫骨平台骨折	jgptgz/
胫前黏液水肿	jqnysz/
静脉曲张综合征	jmqzzhz/
局限性胸膜间皮瘤	jxxxmjpl/
巨细胞病毒性肺炎	jxbbdxfy/
Kartagener综合征	kartagenerzhz/
开放性气胸	kfxqx/
埃博拉病毒病	ablbdb/
堪萨斯分枝杆菌感染	kssfzgjgr/
口周皮炎	kzpy/
库鲁病	klb/
髋臼骨折	kjgz/
眶内海绵状血管瘤	knhmzxgl/
溃疡分枝杆菌感染	kyfzgjgr/
莱姆病性巩膜炎	lmbxgmy/
老年期抑郁症	lnqyyz/
老年性昏迷	lnxhm/
老人腹股沟斜疝	lrfggxs/
泪囊炎	lny/
泪腺肉样瘤病	lxrylb/
里尔黑变病	lehbb/
立克次体痘	lkctd/
利斯特菌脑膜炎	lstjnmy/
门静脉高压	mjmgy/
镰状细胞贫血	lzxbpx/
链杆菌病	lgjb/
良性淋巴上皮病	lxlbspb/
颅底凹陷症	ldaxz/
颅骨骨折	lggz_4058/
颅骨纤维异常增生症	lgxwyczsz/
颅内低压综合征	lndyzhz/
颅内高压综合征	lngyzhz/
颅中窝脑膜瘤	lzwnml/
旅行者腹泻	lxzfx/
Marie-Bamberger综合征	marie_bambergerzhz/
麻痹性肠梗阻	mbxcgz/
麻风	mf/
麦收皮炎	mspy/
脉络膜缺血	mlmqx/
脉络膜转移癌	mlmzya/
慢性化脓性胸膜炎	mxhnxxmy/
慢性进行性眼外肌麻痹	mxjxxywjmb/
慢性乳头状溃疡性脓皮病	mxrtzkyxnpb/
慢性硬脑膜下血肿	mxynmxxz/
慢性自律性房性心动过速	mxzlxfxxdgs/
毛发腺瘤	mfxl/
门静脉海绵样变	mjmhmyb/
迷走神经损伤	mzsjss/
面肌瘫痪	mjth/
面瘫	mt/
埃及血吸虫病	ajxxcb/
拇指掌指关节尺侧侧副韧带损伤	mzzzgjcccfrdss/
内生性软骨瘤	nsxrgl/
内脏动脉慢性闭塞	nzdmmxbs/
奈瑟卡他球菌肺炎	nsktqjfy/
男性乳腺癌	nxrxa/
男性生殖系结核	nxszxjh/
男性特纳综合征	nxtnzhz/
男子乳腺发育	nzrxfy/
脑室内脑膜瘤	nsnnml/
脑外伤伴发的精神障碍	nwsbfdjsza/
年龄相关性白内障	nlxgxbnz/
尿道癌	nda/
镍及其化合物引起的皮肤病	njqhhwyqdpfb/
牛带绦虫病	ndtcb/
脓毒性休克	ndxxk/
脓疱性细菌疹	npxxjz/
诺瓦克病毒性胃肠炎	nwkbdxwcy/
膀胱尿道异物	bgndyw/
膀胱腺癌	bgxa/
反应性关节炎	fyxgjy/
疱疹样脓疱病	pzynpb/
皮肤平滑肌瘤	pfphjl/
皮炎芽生菌	pyysj/
皮脂囊肿病	pznzb/
皮脂腺上皮瘤	pzxspl/
脾脏原发性恶性肿瘤	pzyfxexzl/
偏执状态	pzzt/
平滑肌错构瘤	phjcgl/
匍行性血管瘤	pxxxgl/
葡萄球菌肺炎	ptqjfy/
葡萄球菌性食物中毒	ptqjxswzd/
葡萄球菌中毒性休克综合征	ptqjzdxxkzhz/
Q热肺炎	qrfy/
脐尿管瘘	qngl/
脐膨出	qpc/
脐膨出-巨舌-巨体综合征	qpc_js_jtzhz/
髂腹股沟神经干痛	qfggsjgt/
前房积血与青光眼	qfjxyqgy/
前庭神经元炎	qtsjyy/
轻链病与轻链沉积病	qlbyqlcjb/
嵌杯样病毒胃肠炎	qbybdwcy/
强直性脊柱炎及其伴发的葡萄膜炎	qzxjzyjqbfdptmy/
切口疝	qks/
青霉病	qmb/
大汗腺癌	dhxa/
球形肺炎	qxfy/
屈光参差	qgcc/
躯体感觉障碍	qtgjza/
躯体形式障碍	qtxsza/
醛固酮缺乏症	qgtqfz/
纤维化综合征	xwhzhz/
Rh血型不合	rhxxbh/
人工关节置换术后关节感染	rggjzhshgjgr/
人乳头瘤病毒感染	rrtlbdgr/
融合性网状乳头瘤病	rhxwzrtlb/
乳房猪囊尾蚴病	rfznwyb/
乳糜腹	rmf/
乳头皲裂	rtjl/
乳头状小汗腺腺瘤	rtzxhxxl/
乳腺湿疹样癌	rxszya/
乳腺脂肪肉瘤	rxzfrl/
乳溢-闭经综合征	ry_bjzhz/
弱智	rz/
Ⅳ型肾小管性酸中毒	_xsxgxszd/
鳃裂囊肿和瘘管	slnzhlg/
色素沉着绒毛结节性滑膜炎	ssczrmjjxhmy/
色素失调症	sssdz/
上颈椎不稳症	sjzbwz/
上皮样血管内皮细胞瘤	spyxgnpxbl/
上肢深静脉血栓形成	szsjmxsxc/
少枝胶质细胞瘤及间变少枝胶质细胞瘤	szjzxbljjbszjzxbl/
舌下神经损伤	sxsjss/
舌咽神经损伤	sysjss/
社会获得性肺炎	shhdxfy/
砷化氢引起的溶血性贫血	shqyqdrxxpx/
神经莱姆病	sjlmb/
神经肽性肢端感觉异常	sjtxzdgjyc/
神经系统副肿瘤综合征	sjxtfzlzhz/
神经纤维瘤病	sjxwlb/
神经性肌强直	sjxjqz/
神经源性角膜炎	sjyxjmy/
肾皮质化脓性感染	spzhnxgr/
肾盏憩室	szqs/
生长期脱发	scqtf/
石棉肺	smf/
食管源性胸痛	sgyxxt/
视神经脊髓炎	ssjjsy/
室管膜肿瘤	sgmzl/
嗜酸粒细胞增多症	sslxbzdz/
嗜酸性粒细胞白血病	ssxlxbbxb/
嗜血流感杆菌的皮肤感染	sxlggjdpfgr/
手部屈指肌腱损伤	sbqzjjss/
手指屈肌腱鞘炎	szqjjqy/
书写痉挛	sxjl/
输血后血小板减少性紫癜	sxhxxbjsxzd/
斯蒂尔病	sdeb/
松毛虫性骨关节炎	smcxggjy/
瘫痪	th_4178/
特发性股骨头坏死	tfxggths/
特发性黄斑部前膜	tfxhbbqm/
特发性面神经瘫痪	tfxmsjth/
疼痛性眼肌麻痹	ttxyjmb/
体癣	tx_4183/
头皮糠疹	tpkz/
透析性骨关节病	txxggjb/
土肥对称性肢端色素沉着症	tfdcxzdssczz/
吞入异物	tryw/
B疱疹病毒感染	bpzbdgr/
Whitfield硬红斑	whitfieldyhb/
外伤相关性青光眼	wsxgxqgy/
外伤性胆管损伤	wsxdgss/
外伤性腹膜后出血或血肿	wsxfmhcxhxz/
外伤性脑积水	wsxnjs/
外伤性脂肪坏死	wsxzfhs/
外阴表皮内瘤变	wybpnlb/
外阴瘙痒症	wysyz/
外源性变应性肺泡炎	wyxbyxfpy/
网膜扭转	wmnz_4198/
纹状体黑质变性	wzthzbx/
无菌性肋软骨炎	wjxlrgy/
X联锁鱼鳞病	xlsylb/
全身性红斑狼疮	qsxhblc/
细菌性角膜炎	xjxjmy/
下部附加前根脊髓动脉缺血症候群	xbfjqgjsdmqxzhq/
下颌下间隙感染	xhxjxgr/
先天性白血病	xtxbxb/
先天性肠旋转不良	xtxcxzbl/
先天性尺桡骨性连接	xtxcrgxlj/
先天性纯红细胞再生障碍性贫血	xtxchxbzszaxpx/
先天性胆管囊状扩张	xtxdgnzkz/
埃布斯坦综合征	abstzhz/
先天性高弓足	xtxggz/
先天性冠状动脉瘘	xtxgzdml/
先天性红细胞生成异常性贫血	xtxhxbscycxpx/
先天性静脉畸形肢体肥大综合征	xtxjmjxztfdzhz/
先天性髋关节脱位	xtxkgjtw/
先天性卵巢发育不全	xtxlcfybq/
先天性肾病综合征	xtxsbzhz/
先天性十二指肠闭锁	xtxsezcbs/
先天性视网膜劈裂症	xtxswmplz/
先天性胃壁肌层缺损	xtxwbjcqs/
先天性小眼球合并眼眶囊肿	xtxxyqhbyknz/
先天性血管瘤	xtxxgl/
先天性远端尺桡关节半脱位	xtxydcrgjbtw/
先天性跖骨内收畸形	xtxzgnsjx/
纤维肌痛综合征	xwjtzhz_4226/
纤维毛囊瘤	xwmnl/
纤维性骨炎	xwxgy/
腺性唇炎	xxcy/
相对性红细胞增多症	xdxhxbzdz/
小肠纤维瘤	xcxwl/
小儿急性呼吸窘迫综合征	xejxhxjpzhz/
小儿食管化学性烧伤	xesghxxss/
小脑扁桃体下疝畸形	xnbttxsjx/
新生儿低镁血症	xsedmxz/
新生儿流行性腹泻	xselxxfx/
新生儿脓疱疮	xsenpc/
猩红热样红斑	xhryhb/
性心理障碍	xxlza/
癣菌疹	xjz/
血管畸形引起的吞咽困难	xgjxyqdtykn/
血管内乳头状血管内皮细胞瘤	xgnrtzxgnpxbl/
血管神经性水肿	xgsjxsz/
血管纤维瘤	xgxwl/
雅司病	ysb_4245/
咽囊炎	yny/
言语和语言发育障碍	yyhyyfyza/
眼睑皮脂腺癌	yjpzxa/
眼球后退综合征	yqhtzhz/
眼球内炎	yqny/
眼球运动障碍	yqydza/
腰部峡部崩裂和脊椎滑脱	ybxbblhjzht/
腰椎退变性小关节损伤性关节炎	yztbxxgjssxgjy/
药物导致的肺部疾病	ywdzdfbjb/
腋毛癣菌病	ymxjb/
原发性皮肤结核综合征	yfxpfjhzhz/
衣原体淋巴肉芽肿	yytlbryz/
胰岛素抵抗与代谢综合征	ydsdkydxzhz/
遗传性出血性毛细血管扩张	ycxcxxmxxgkz/
乙状结肠间疝	yzjcjs/
异染性脑白质营养不良	yrxnbzyybl/
弗郎西丝菌肺炎	flxsjfy/
异源内分泌综合征	yynfmzhz/
阴部鲍恩样丘疹病	ybbeyqzb/
阴道粒细胞肉瘤	ydlxbrl/
阴道美丽筒线虫病	ydmltxcb/
阴茎阴囊象皮肿	yjynxpz/
阴茎折断	yjzd/
银屑病关节炎及其伴发的葡萄膜炎	yxbgjyjqbfdptmy/
隐斜	yx/
婴儿成神经细胞瘤	yecsjxbl/
婴儿痤疮	yecc/
婴儿肌纤维瘤病	yejxwlb/
婴儿期短暂性低丙球蛋白血症	yeqdzxdbqdbxz/
婴儿青铜综合征	yeqtzhz/
婴幼儿外阴阴道炎	yyewyydy/
硬脑膜外脓肿	ynmwnz/
硬肿症	yzz/
尤因肉瘤	yyrl/
疣状癌	yza/
疣状角化不良病	yzjhblb/
幼年型类风湿性关节炎	ynxlfsxgjy/
原发性肺动脉高压	yfxfdmgy/
原发性骨淋巴瘤	yfxglbl/
原发性卵巢类癌综合征	yfxlclazhz/
原发性下肢深静脉瓣膜关闭不全	yfxxzsjmbmgbbq/
远端肾小管性酸中毒	ydsxgxszd/
月骨脱位及月骨周围脱位	ygtwjygzwtw/
运动诱发哮喘	ydyfxc/
晕痣	yz_4290/
跗骨与周围关节结核	fgyzwgjjh/
早期复极综合征	zqfjzhz/
增龄性黄斑变性	zlxhbbx/
蛰伏脂瘤	zfzl/
真两性畸形	zlxjx/
枕骨大孔脑膜瘤	zgdknml/
脂蛋白肾小球病	zdbsxqb/
脂肪栓塞综合征	zfsszhz/
直肠内套叠	zcntd/
直肠膨出	zcpc/
直肠子宫内膜异位症	zczgnmywz/
植物神经系统肿瘤	zwsjxtzl/
跖骨骨折	zggz/
指骨骨折	zggz_4304/
致命性中线肉芽肿	zmxzxryz/
智能障碍	znza/
中老年男子部分性雄激素缺乏综合征	zlnnzbfxxjsqfzhz/
中性粒细胞减少症	zxlxbjsz/
肿瘤性心包炎	zlxxby/
周期性动眼神经麻痹	zqxdysjmb/
周期性内斜视	zqxnxs/
肘关节强直与纤维性僵硬	zgjqzyxwxjy/
肘管综合征	zgzhz/
肘外翻畸形	zwfjx/
主动脉瓣闭锁不全	zdmbbsbq/
着色杆菌病	zsgjb/
滋养细胞肿瘤	zyxbzl/
足舟骨骨折	zzggz/
组织细胞坏死性淋巴结炎	zzxbhsxlbjy/
热带性肺嗜酸性粒细胞浸润症	rdxfssxlxbjrz/
一氧化碳中毒后迟发性脑病	yyhtzdhcfxnb/
克-雅氏病性痴呆	k_ysbxcd/
分泌过多性青光眼	fmgdxqgy/
腹茧症	fjz/
腹裂	fl_4325/
腹胀	fz_4326/
经腹会阴直肠癌根治术后盆底腹膜疝	jfhyzcagzshpdfms/
发育不良痣	fyblz/
肝海绵状血管瘤	ghmzxgl/
功能性下丘脑性闭经	gnxxqnxbj/
膈下食管憩室	gxsgqs/
膈上食管憩室	gssgqs/
新生儿呕血和便血	xseoxhbx/
肾小管间质性肾炎葡萄膜炎综合征	sxgjzxsyptmyzhz/
樱桃状血管瘤	ytzxgl/
多发性内分泌腺瘤Ⅱ型	dfxnfmxl_x/
腓总神经损伤	fzsjss/
结节性硬化症	jjxyhz/
神经鞘黏液瘤	sjqnyl/
神经母细胞瘤	sjmxbl/
遗传性痉挛性截瘫	ycxjlxjt/
松果体细胞瘤	sgtxbl/
结节病性心肌病	jjbxxjb/
新生儿皮下脂肪坏死	xsepxzfhs/
Ⅰ型免疫母细胞性淋巴腺病	_xmymxbxlbxb/
进行性肥厚性间质性神经炎	jxxfhxjzxsjy/
焦磷酸钙沉积病	jlsgcjb/
颅内脂肪瘤	lnzfl/
神经节苷脂沉积病	sjjgzcjb/
散发性脑炎伴发的精神障碍	sfxnybfdjsza/
肝肾综合征	gszhz/
附红细胞体病	fhxbtb/
输精管缺如	sjgqr/
遗尿	yn_4354/
腹膜后脂肪瘤	fmhzfl/
腓总神经卡压症	fzsjkyz/
距骨骨折脱位	jggztw/
聚合性痤疮	jhxcc/
胫腓骨骨干骨折	jfggggz/
进行性肢端黑变病	jxxzdhbb/
胫腓下联合前部分离	jfxlhqbfl/
髋关节前脱位	kgjqtw/
缺水和缺钠	qshqn/
桡骨颈骨折和桡骨头骨骺分离	rgjgzhrgtghfl/
桡骨茎突部狭窄性腱鞘炎	rgjtbxzxjqy/
桡骨远端骨骺分离	rgydghfl/
锁骨下动脉盗血综合征	sgxdmdxzhz/
枢椎椎体骨折	szztgz/
颈椎先天融合畸形	jzxtrhjx/
咽部及颈部食管闭合性损伤	ybjjbsgbhxss/
疖与疖病	jyjb/
非依赖性物质伴发依赖	fylxwzbfyl/
软化斑	rhb/
软骨黏液样纤维瘤	rgnyyxwl/
眼眶神经鞘瘤	yksjql/
胎儿窘迫	tejp/
结膜结核病	jmjhb/
眶骨膜下脓肿	kgmxnz/
绿脓假单胞菌属感染	lnjdbjsgr/
眼眶静脉性血管瘤	ykjmxxgl/
眼球震颤阻滞综合征	yqzczzzhz/
眼科重症肌无力	ykzzjwl/
惊恐症	jkz/
间接型颈动脉海绵窦瘘	jjxjdmhmdl/
圣路易斯型脑炎	slysxny/
蝎螫伤	xss/
少年儿童葡萄膜炎	snetptmy/
洋葱假单胞菌肺炎	ycjdbjfy/
柯萨奇病毒疹	ksqbdz/
口蹄疫	kty/
全身性特发性毛细血管扩张症	qsxtfxmxxgkzz/
肉瘤	rl/
恙虫病性肺炎	ycbxfy/
甲沟炎和甲下脓肿	jgyhjxnz/
神经白塞病	sjbsb/
甲状腺功能减退性心肌病	jzxgnjtxxjb/
四边孔综合征	sbkzhz/
阴囊丝虫病	ynscb/
成人类风湿性关节炎性巩膜炎	crlfsxgjyxgmy/
大脑大静脉瘤	dndjml/
肺隔离症	fglz/
肺疝	fs/
白蛉热	blr/
放射性脊髓病	fsxjsb/
非典型分枝杆菌性巩膜炎	fdxfzgjxgmy/
肺转移性肿瘤	fzyxzl/
肺真菌病	fzjb/
铬及其化合物引起的皮肤病	gjqhhwyqdpfb/
感染性血小板减少性紫癜	grxxxbjsxzd/
过敏性血管炎	gmxxgy/
过敏性急性小管间质性肾炎	gmxjxxgjzxsy/
共济失调	gjsd/
呼吸道合胞病毒感染	hxdhbbdgr/
急性肺源性心脏病	jxfyxxzb/
卡斯钦-贝克病	ksq_bkb/
Leber遗传性视神经病变	leberycxssjbb/
硫化血红蛋白血症	lhxhdbxz/
流行性甲型脑炎	lxxjxny/
皮层性多汗症	pcxdhz/
青春发育延迟及性幼稚	qcfyycjxyz/
气球状细胞痣	qqzxbz/
气管闭合性损伤	qgbhxss/
乳头的乳头状瘤	rtdrtzl/
手癣	sx/
小儿颅后窝室管膜瘤	xelhwsgml/
硒及其化合物引起的皮肤病	xjqhhwyqdpfb/
小儿感染性心内膜炎	xegrxxnmy/
新生儿化脓性脑膜炎	xsehnxnmy/
新生儿水肿	xsesz/
乙脑伴发的精神障碍	ynbfdjsza/
延迟性应激反应	ycxyjfy/
煤炭工尘肺	mtgcf/
穿凿脓肿性头部毛囊炎及毛囊周围炎	cznzxtbmnyjmnzwy/
窦性心动过缓	dxxdgh/
单眼双上转肌麻痹	dysszjmb/
肺胸膜阿米巴病	fxmambb/
伏格特-小柳-原田综合征	fgt_xl_ytzhz/
房室交接区性期前收缩	fsjjqxqqss/
钒及其化合物引起的皮肤病	fjqhhwyqdpfb/
肺动脉发育不全	fdmfybq/
冠状动脉粥样硬化性心脏病	gzdmzyyhxxzb/
间歇依赖型尖端扭转型室性心动过速	jxylxjdnzxsxxdgs/
急性高原病	jxgyb/
雷诺氏病	lnsb/
松弛性跖痛症	scxztz/
晚期产后出血	wqchcx/
完全性房室传导阻滞	wqxfscdzz/
新生儿暂时性脓疱性黑变病	xsezsxnpxhbb/
血管免疫母细胞性淋巴结病	xgmymxbxlbjb/
血栓形成	xsxc/
心室肌致密化不全	xsjzmhbq/
小儿睾丸扭转	xegwnz/
先天性短结肠	xtxdjc/
血管脂肪瘤	xgzfl/
亚急性坏死性脊髓炎	yjxhsxjsy/
坐骨疝	zgs/
左心房心律	zxfxl/
注意缺陷障碍	zyqxza/
阿洪病	ahb/
暴发性肝衰竭	bfxgsj/
闭合性脊髓损伤	bhxjsss/
彼得异常	bdyc/
避孕后闭经综合征	byhbjzhz/
猝死型冠心病	csxgxb/
肠系膜动脉瘤	cxmdml/
肠子宫内膜异位	czgnmyw/
藏毛窦和藏毛囊肿	cmdhcmnz/
肠道短路关节炎皮炎综合征	cddlgjypyzhz/
肠道息肉病	cdxrb/
肠系膜脂肪炎	cxmzfy/
胆总管结石	dzgjs/
大肠腺瘤	dcxl/
胆汁性腹膜炎	dzxfmy/
毒瘾	dy/
骶骼筋膜脂肪疝	dgjmzfs/
α-贮存池病	_zccb/
沙漠疮	smc/
福克斯-阜太斯病	fks_ftsb/
副乳乳腺癌	frrxa/
钩虫皮炎	gcpy/
肝错构瘤	gcgl/
肛管癌	gga/
化脓性甲沟炎	hnxjgy/
回旋形线状鱼鳞病	hxxxzylb/
蛔虫性肠梗阻	hcxcgz/
霍奇金病	hqjb/
弹响肩胛	dxjj/
急性胆源性胰腺炎	jxdyxyxy/
克拉伯病	klbb/
溃疡病出血	kybcx/
鳞状毛囊角化病	lzmnjhb/
巴德-吉亚利综合征	bd_jylzhz/
氯气中毒	lqzd/
罗阿丝虫病	lascb/
良性脂肪母细胞瘤	lxzfmxbl/
老年甲状腺功能减退症	lnjzxgnjtz/
狼疮肾炎	lcsy/
蓝痣	lz/
Mirizzi综合征	mirizzizhz/
盲襻综合征	mpzhz_4500/
尼兹诺夫综合征	nznfzhz/
巴贝虫病	bbcb/
农药中毒所致的精神障碍	nyzdszdjsza/
囊状淋巴管瘤	nzlbgl/
铍及其化合物引起的皮肤病	pjqhhwyqdpfb/
POEMS综合征	poemszhz/
器械性食管损伤	qxxsgss/
情感性心境障碍	qgxxjza/
水母皮炎	smpy/
四肢淋巴水肿	szlbsz/
十二指肠炎	sezcy/
十二指肠重复畸形	sezczfjx/
史密斯骨折	smsgz/
食管受压性吞咽困难	sgsyxtykn/
食管肉瘤	sgrl/
食管蹼和食管环	sgphsgh/
食管贲门黏膜撕裂综合征	sgbmnmslzhz/
食管壁内憩室	sgbnqs/
食管外压和牵拉	sgwyhql/
沙雷菌肺炎	sljfy/
听力障碍	tlza/
糖原贮积病	tyzjb/
特发性肺含铁血黄素沉着症	tfxfhtxhsczz/
无机盐所致的皮肤病	wjyszdpfb/
胃窦血管扩张症	wdxgkzz/
稳定型心绞痛	wdxxjt/
网状红斑萎缩性毛囊炎	wzhbwsxmny/
先天性尺骨缺如	xtxcgqr/
先天性腓骨缺如	xtxfgqr/
小儿洋地黄中毒	xeydhzd/
小儿帕套综合征	xeptzhz/
小肠扭转	xcnz/
小儿小颌畸形综合征	xexhjxzhz/
须部假毛囊炎	xbjmny/
先天性食管憩室	xtxsgqs/
小儿先天性卵巢发育不全	xextxlcfybq/
乙型病毒性肝炎	yxbdxgy/
右室心肌梗死	ysxjgs/
幽门螺杆菌感染	ymlgjgr/
真菌性心包炎	zjxxby/
真菌性巩膜炎	zjxgmy/
巴西紫热	bxzr/
成人肥大性幽门狭窄	crfdxymxz/
多乳房	drf/
低钾血症肾病	djxzsb/
非ST段抬高心肌梗死	fstdtgxjgs/
肝脏疾病所致贫血	gzjbszpx/
高颅压性脑积水	glyxnjs/
急性蜂窝织炎	jxfwzy/
脊膜瘤	jml/
急性视网膜坏死综合征	jxswmhszhz/
免疫缺陷性肺炎	myqxxfy/
小儿尿路感染	xenlgr/
小儿肾性氨基酸尿症	xesxajsnz/
原发性阿米巴脑膜脑炎	yfxambnmny/
阿克森费尔德-里格尔综合征	aksfed_lgezhz/
Austin型幼儿脑硫脂病	austinxyenlzb/
阿司匹林诱发哮喘	asplyfxc/
海绵状淋巴管瘤	hmzlbgl/
颈椎单侧及双侧小关节脱位	jzdcjscxgjtw/
脊髓血管畸形	jsxgjx/
酒精中毒性肌病	jjzdxjb/
老年大便失禁	lndbsj/
肋骨骨髓炎	lggsy_4564/
淋巴细胞性垂体炎	lbxbxcty/
脑干胶质瘤	ngjzl/
偏执狂	pzk/
帕金森病性痴呆	pjsbxcd/
Stargardt病	stargardtb/
三叉神经营养性损害	scsjyyxsh/
糖代谢异常伴发的精神障碍	tdxycbfdjsza/
奥迪括约肌功能异常	adkyjgnyc/
新生儿巨细胞病毒感染	xsejxbbdgr/
小儿脑性瘫痪	xenxth/
症状性癫痫综合征	zzxdxzhz/
镇痛剂肾病	ztjsb/
周围动脉栓塞	zwdmss/
多发性脑膜瘤	dfxnml/
高眼压症	gyyz/
急性腮腺炎性睾丸炎	jxsxyxgwy/
克雷白杆菌属感染	klbgjsgr/
嘧啶5′-核苷酸缺乏症	md5__hgsqfz/
维生素D缺乏病	wssdqfb/
维生素E缺乏神经病	wsseqfsjb/
新生儿发热	xsefr/
血卟啉病性周围神经病	xblbxzwsjb/
下丘脑综合征	xqnzhz/
显微镜下多血管炎	xwjxdxgy/
缢死	ys/
百草枯中毒	bckzd/
复孔绦虫病	fktcb/
鞍结节脑膜瘤	ajjnml/
过敏性紫癜肾炎	gmxzdsy/
获得性血友病	hdxxyb/
女性性高潮障碍	nxxgcza/
脾良性肿瘤	plxzl/
葡萄状肉瘤	ptzrl/
失盐性肾炎	syxsy/
维斯科特-奥尔德里奇综合征	wskt_aedlqzhz/
遗传性蛋白C缺陷症	ycxdbcqxz/
小儿过敏性紫癜	xegmxzd/
血管内大B细胞淋巴瘤	xgndbxblbl/
新生儿持续性肺动脉高压	xsecxxfdmgy/
新生儿肾静脉血栓	xsesjmxs/
异尖线虫病	yjxcb/
左房恶性黏液瘤	zfexnyl/
多发性骨骺发育不良	dfxghfybl/
多发性肌炎和皮肌炎伴发的精神障碍	dfxjyhpjybfdjsza/
混合瘤	hhl/
巨细胞动脉炎和风湿性多肌痛	jxbdmyhfsxdjt/
结节性多动脉炎伴发的葡萄膜炎	jjxddmybfdptmy/
皮肤颌口虫病	pfhkcb/
艾滋病神经系统损害	azbsjxtsh/
瑞尔黑变病	rehbb/
痛风性心肌病	tfxxjb/
血清病和血清病样反应	xqbhxqbyfy/
原发性皮肤B细胞淋巴瘤	yfxpfbxblbl/
药物或化学物质所致的色素沉着	ywhhxwzszdsscz/
重金属中毒性肾病	zjszdxsb/
癌肿性关节炎	azxgjy/
动脉阻塞或狭窄视网膜病变	dmzshxzswmbb/
肺并殖吸虫病	fbzxcb/
肺孢子丝菌病	fbzsjb/
继发于无晶状体眼和人工晶状体眼的青光眼	jfywjztyhrgjztydqgy/
慢性萎缩性肢皮炎	mxwsxzpy/
食管梅毒	sgmd/
梭形细胞血管内皮细胞瘤	sxxbxgnpxbl/
外伤性硬膜下积液	wsxymxjy/
胸内甲状腺肿	xnjzxz/
心脏横纹肌瘤	xzhwjl/
幼儿急疹	yejz/
永存原始玻璃体增生症	ycysbltzsz/
原卟啉病	yblb/
原藻病	yzb_4634/
纵隔气肿	zgqz/
椎动脉创伤性栓塞	zdmcsxss/
东方马型脑炎	dfmxny/
呃逆	en/
耳湿疹	esz/
黄斑裂孔性视网膜脱离	hblkxswmtl/
脊柱裂和有关畸形	jzlhygjx/
脊髓型颈椎病	jsxjzb/
颅骨骨瘤	lggl/
颅狭症	lxz/
脑猪囊尾蚴病	nznwyb/
脑膜癌病	nmab/
丘疹坏死性结核疹	qzhsxjhz/
外伤后颈内动脉闭塞	wshjndmbs/
新生儿弥散性血管内凝血	xsemsxxgnnx/
中间葡萄膜炎	zjptmy/
尿道结核	ndjh/
膀胱脱垂	bgtc/
肾上腺髓质增生	ssxszzs/
肾周围炎	szwy/
烟酸缺乏	ysqf/
I型糖尿病	ixtnb/
A链球菌群感染	alqjqgr/
肛周肿瘤	gzzl/
股动脉瘤	gdml/
纳尔逊综合征	nexzhz/
蛲虫性阴道炎	ncxydy/
柞蚕蛹脑病	zcynb/
变性近视的脉络膜萎缩	bxjsdmlmws/
感染性急性小管间质性肾炎	grxjxxgjzxsy/
肱骨髁间骨折	ggkjgz/
骨神经鞘瘤	gsjql/
肱骨远端全骨骺分离	ggydqghfl/
骨髓-胰腺综合征	gs_yxzhz/
踝部急性韧带损伤	hbjxrdss/
腹腔妊娠	fqrs/
脊髓蛛网膜炎	jszwmy/
脊髓火器伤	jshqs/
桡骨干骨折	rgggz/
热带痉挛性轻截瘫	rdjlxqjt/
同种免疫性新生儿血小板减少性紫癜	tzmyxxsexxbjsxzd/
胸椎椎管狭窄症	xzzgxzz/
眼眶肌炎	ykjy/
跖骨头骨软骨病	zgtgrgb/
椎管内脊膜瘤	zgnjml/
闭合性气胸	bhxqx/
鼻疽	bj_4681/
贝壳甲综合征	bkjzhz/
电击伤所致脊髓病	djsszjsb/
喉部钝挫伤	hbdcs/
急性失血性贫血	jxsxxpx/
血影细胞性青光眼	xyxbxqgy/
电灼伤	dzs/
热性嗜中性白细胞皮肤病	rxszxbxbpfb/
小儿砷中毒	xeszd/
眼酸碱化学伤	ysjhxs/
急性放射性甲状腺炎	jxfsxjzxy/
夏季皮炎	xjpy/
长Q-T间期综合征	cq_tjqzhz/
恶性黑素瘤	exhsl/
腹膜假黏液瘤	fmjnyl/
颈部纤维瘤	jbxwl/
卡波西水痘样疹	kbxsdyz/
淋巴丝虫病	lbscb/
弥漫性筋膜炎	mmxjmy/
Pancoast综合征	pancoastzhz/
外阴白化病	wybhb/
阴茎结核	yjjh/
α1-抗胰蛋白酶缺乏性脂膜炎	1_kydbmqfxzmy/
触电	cd_4704/
迪厄拉富瓦病	delfwb/
单纯性外阴阴道念珠菌病	dcxwyydnzjb/
宫颈复发癌	gjffa/
复发性髌骨脱位	ffxbgtw/
宫颈腺癌	gjxa/
庚型病毒性肝炎	gxbdxgy/
急性纵隔炎	jxzgy/
急性共同性斜视	jxgtxxs/
老年性紫癜	lnxzd/
盆腔炎性肿块	pqyxzk/
盆腔结缔组织炎	pqjdzzy/
前置血管	qzxg/
妊娠瘙痒性荨麻疹性丘疹及斑块病	rssyxqmzxqzjbkb/
妊娠合并特发性血小板减少性紫癜	rshbtfxxxbjsxzd/
胎死宫内	tsgn/
痛性肥胖病	txfpb/
外阴-阴道-牙龈综合征	wy_yd_yyzhz/
先天性无转铁蛋白血症	xtxwztdbxz/
月经过多	yjgd/
阴道横纹肌肉瘤	ydhwjrl/
多胎妊娠	dtrs/
弓形体病	gxtb/
流感病毒肺炎	lgbdfy/
肠瘘	cl_4728/
楚尔盖分枝杆菌感染	cegfzgjgr/
急性肠系膜淋巴结炎	jxcxmlbjy/
朗格汉斯组织细胞增多症	lghszzxbzdz/
水蛭咬伤	szys/
维生素B1缺乏症	wssb1qfz/
维生素A缺乏神经病	wssaqfsjb/
小儿马方综合征	xemfzhz/
自发性腹膜后出血或血肿	zfxfmhcxhxz/
瘢痕性脱发	bhxtf/
表皮内嗜中性IgA皮肤病	bpnszxigapfb/
包茎	bj_4739/
纯红细胞再生障碍	chxbzsza/
蚕食性角膜溃疡	csxjmky_4741/
低增生性急性白血病	dzsxjxbxb/
单纯疱疹性脑炎	dcpzxny/
汞及其化合物引起的皮肤病	gjqhhwyqdpfb_4744/
化脓性食管炎	hnxsgy/
虹膜色素痣	hmssz/
急性腰背部扭伤	jxybbns/
睑皮松垂症	jpscz/
畸胎瘤	jtl/
淋球菌感染	lqjgr/
流行性角膜结膜炎	lxxjmjmy/
阿米巴结肠炎	ambjcy/
匐行性脉络膜萎缩	fxxmlmws/
沙眼衣原体肺炎	syyytfy/
视网膜毛细血管血管瘤	swmmxxgxgl/
视网膜后膜	swmhm/
视网膜下纤维化和葡萄膜炎综合征	swmxxwhhptmyzhz/
特发性青春期延迟	tfxqcqyc/
隐性脊柱裂	yxjzl/
眼眶骨肉瘤	ykgrl/
原发性输卵管癌	yfxslga/
眼部毛细血管瘤	ybmxxgl/
眼睑恶性黑色素细胞肿瘤	yjexhssxbzl/
阿-斯综合征	a_szhz/
真菌性尿路感染	zjxnlgr/
耳廓软骨膜炎	ekrgmy/
慢性反流性肾病	mxflxsb/
猴痘	hd_4768/
喉上神经损伤	hssjss/
急性髌骨脱位	jxbgtw/
急性后部多灶性鳞状色素上皮病变	jxhbdzxlzssspbb/
甲状舌管囊肿	jzsgnz/
急性坏死出血性脑脊髓炎	jxhscxxnjsy/
链球菌中毒性休克综合征	lqjzdxxkzhz/
弥漫性胸膜间皮瘤	mmxxmjpl/
慢性腰背痛	mxybt/
浅表性皮肤脂肪瘤痣	qbxpfzflz/
气管及支气管发育障碍	qgjzqgfyza/
卫氏并殖吸虫病	wsbzxcb/
先天性后尿道瘘	xtxhndl/
先天性长结肠	xtxcjc/
烟酸缺乏神经病	ysqfsjb/
咽后间隙感染	yhjxgr/
咽食管憩室	ysgqs/
变应性皮肤结节性血管炎	byxpfjjxxgy/
单发脑梗死性痴呆	dfngsxcd_4786/
匐行穿孔性弹性组织变性	fxckxdxzzbx/
环咽肌失弛缓症	hyjschz/
褐黄病	hhb_4789/
黑舌	hs/
甲氨蝶呤相关的淋巴增殖性疾病	jadlxgdlbzzxjb/
口角炎	kjy/
口腔毛滴虫病	kqmdcb/
口腔菜花状乳头瘤病	kqchzrtlb/
口腔灶性上皮增生	kqzxspzs/
颏下皮样囊肿	kxpynz/
眶周色素沉着	kzsscz/
膜性肾病	mxsb/
牙源性皮瘘	yyxpl/
下颈椎不稳症	xjzbwz/
颜面复发性皮炎	ymffxpy/
淤积性皮炎	yjxpy/
埃利希体病	alxtb_4803/
包涵体肌炎与遗传性包涵体肌病	bhtjyyycxbhtjb/
布氏杆菌红斑	bsgjhb/
胞内分枝杆菌感染	bnfzgjgr/
传染性淋巴细胞增多症	crxlbxbzdz/
单纯性雀斑样痣	dcxqbyz/
带状疱疹病毒性巩膜炎	dzpzbdxgmy/
等孢球虫病	dbqcb/
单纯疱疹病毒性巩膜炎	dcpzbdxgmy/
非01霍乱弧菌肠炎	f01hlhjcy/
钩端螺旋体病的肾损害	gdlxtbdssh/
回归热型结节性非化脓性脂膜炎	hgrxjjxfhnxzmy/
黄韧带骨化症	hrdghz/
间插血吸虫病	jcxxcb/
阿尔茨海默病性痴呆	aechmbxcd/
类鼻疽杆菌肺炎	lbjgjfy/
囊性肾病	nxsb/
性功能异常伴发的精神障碍	xgnycbfdjsza/
职业性痤疮	zyxcc/
软纤维瘤	rxwl/
散发性甲状腺肿	sfxjzxz/
水痘-带状疱疹性葡萄膜炎	sd_dzpzxptmy/
鼠疫耶尔森菌肺炎	syyesjfy/
投掷骨折	tzgz/
退变性骶髂关节炎	tbxdqgjy/
结核性心包炎	jhxxby/
花粉过敏性哮喘	hfgmxxc/
旋前圆肌综合征	xqyjzhz/
光化性角化病	ghxjhb/
新生儿ABO溶血病	xseaborxb/
分离性垂直偏斜	flxczpx/
芽生菌病样脓皮病	ysjbynpb/
多形性脂肪瘤	dxxzfl/
羊膜带综合征	ymdzhz/
斑疹伤寒立克次体肺炎	bzshlkctfy/
隐翅虫皮炎	yccpy/
白发	bf/
张力性气胸	zlxqx/
自主性高功能性甲状腺腺瘤	zzxggnxjzxxl/
制药业引起的皮肤病	zyyyqdpfb/
蜂窝肺综合征	fwfzhz/
急性女阴溃疡	jxnyky/
接合菌病	jhjb/
毛囊周角化病	mnzjhb/
麻疹病毒肺炎	mzbdfy/
女性膀胱颈梗阻	nxbgjgz/
扭转痉挛	nzjl/
佩吉特病样网状细胞增生症	pjtbywzxbzsz/
全身黏液性水肿	qsnyxsz/
脂质沉积性肌病	zzcjxjb/
湿疹样癌	szya/
色素性青光眼	ssxqgy/
霜样树枝状视网膜血管炎	syszzswmxgy/
叶酸缺乏神经病	ysqfsjb_4856/
药物性食管炎	ywxsgy/
梅毒肾病	mdsb/
癫痫持续状态	dxcxzt/
苯丙酮尿症	bbtnz/
高原性心脏病	gyxxzb/
急性卵巢、输卵管自身扭转	jxlc_slgzsnz/
麦格综合征	mgzhz/
慢性膀胱炎	mxbgy/
孟氏骨折	msgz/
膜迷路积水	mmljs/
Nezelot综合征	nezelotzhz/
慢性劳损性颈背部筋膜纤维织炎	mxlsxjbbjmxwzy/
小儿急性淋巴细胞性白血病	xejxlbxbxbxb/
小儿精神发育迟缓	xejsfych/
颞动脉炎	ndmy/
小儿急性中毒	xejxzd/
小儿肺炎链球菌肺炎	xefylqjfy/
先天性风疹综合征	xtxfzzhz/
胸主动脉瘤	xzdml/
先天性非溶血性黄疸	xtxfrxxhd/
心房心肌梗死	xfxjgs/
心脏黏液瘤	xznyl/
心室静止	xsjz/
自发性蛛网膜下腔出血	zfxzwmxqcx/
主动脉肠道瘘	zdmcdl/
Bazin硬红斑	bazinyhb/
肠系膜囊肿	cxmnz/
胆固醇肺炎	dgcfy/
反社会人格障碍(病态人格)	fshrgza_btrg_/
横结肠扭转	hjcnz/
家族性进行性色素沉着	jzxjxxsscz/
克罗恩病关节炎	klebgjy/
弥漫性特发性骨肥厚	mmxtfxgfh/
毛细胞白血病	mxbbxb/
癌性疼痛	axtt/
急性间歇性卟啉病	jxjxxblb/
脚气病性心脏病	jqbxxzb/
原发性阴道恶性淋巴瘤	yfxydexlbl/
急性侵袭型肺曲霉病	jxqxxfqmb/
耻骨炎	cgy/
钴及其化合物引起的皮肤病	gjqhhwyqdpfb_4897/
脊髓梅毒	jsmd/
畸形性吞咽困难	jxxtykn/
进行性面偏侧萎缩症	jxxmpcwsz/
软骨外胚层发育不全	rgwpcfybq/
膝关节内侧副韧带断裂	xgjncfrddl/
腰疝	ys_4903/
眼眶横纹肌肉瘤	ykhwjrl/
椎管内神经鞘瘤	zgnsjql/
心脏神经症	xzsjz/
小儿抽动秽语综合征	xecdhyzhz/
心室扑动和心室颤动	xspdhxscd/
热带型肺嗜酸性粒细胞肺炎	rdxfssxlxbfy/
十二指肠先天性狭窄	sezcxtxxz/
上斜肌腱鞘综合征	sxjjqzhz/
十二指肠外瘘	sezcwl/
β受体亢进症	stkjz/
十二指肠结核	sezcjh/
特发性息肉样脉络膜血管病变	tfxxrymlmxgbb/
胃型哮喘	wxxc/
胃神经纤维瘤	wsjxwl/
胃憩室	wqs/
胃平滑肌瘤	wphjl/
胃溃疡	wky/
胃结核	wjh/
胃内隔膜	wngm/
胃肠道间质瘤	wcdjzl/
胃真菌病	wzjb/
胃切除后吸收不良综合征	wqchxsblzhz/
温抗体型自身免疫性溶血性贫血	wktxzsmyxrxxpx/
无睾症	wgz/
尾骨骨折与脱位	wggzytw/
胃梅毒	wmd/
消散延迟性肺炎	xsycxfy/
先天性巨尿道症	xtxjndz/
小儿急性胆囊炎与胆管炎	xejxdnyydgy/
下腰椎不稳症	xyzbwz/
心源性哮喘	xyxxc/
新生儿肛门和直肠畸形	xsegmhzcjx/
血吸虫尾蚴性皮炎	xxcwyxpy/
希恩综合征	xezhz/
心血管疾病伴发的精神障碍	xxgjbbfdjsza/
先天性拇内翻	xtxmnf/
血色病性骨关节病	xsbxggjb/
药物性心肌病	ywxxjb/
营养不良性皮肤钙化病	yyblxpfghb/
药物性呼吸衰竭	ywxhxsj/
原发性腹膜炎	yfxfmy/
直肠脱垂直肠壁内疝	zctczcbns/
低血糖	dxt/
高温引起的溶血性贫血	gwyqdrxxpx/
近端肾小管性酸中毒	jdsxgxszd/
痛风和高尿酸血症	tfhgnsxz/
小儿副流感病毒肺炎	xeflgbdfy/
癌症伴发的精神障碍	azbfdjsza/
胸骨裂	xgl_4952/
脑蛛网膜炎	nzwmy/
脑棘球蚴病	njqyb/
脑静脉畸形	njmjx/
脑膜肉瘤	nmrl/
先天性前尿道瓣膜	xtxqndbm/
胆道蛔虫病与肝蛔虫病	ddhcbyghcb/
胆道华支睾吸虫病	ddhzgxcb/
胰腺囊腺瘤和囊腺癌	yxnxlhnxa/
原发性直立性低血压	yfxzlxdxy/
胰腺异位	yxyw/
胰多肽瘤	ydtl/
睾丸女性化	gwnxh/
尿路软斑症	nlrbz/
肾错构瘤	scgl/
肾脏疾病伴发的精神障碍	szjbbfdjsza/
肛窦炎及肛乳头炎	gdyjgrty/
难治性癫痫	nzxdx/
小肠重复畸形	xczfjx/
阴道黑色素瘤	ydhssl/
子宫内膜间质肉瘤	zgnmjzrl/
中心性渗出性脉络膜视网膜病变	zxxscxmlmswmbb/
阵发性冷性血红蛋白尿	zfxlxxhdbn/
输尿管瓣膜	sngbm/
子宫颈残端癌	zgjcda/
子宫切除术后会阴疝	zgqcshhys/
子宫内膜增生	zgnmzs/
子宫腺肌病	zgxjb/
产后甲状腺炎	chjzxy/
早产儿贫血	zcepx/
巨大肥厚性胃炎	jdfhxwy/
拇外翻	mwf/
小儿热带巨脾综合征	xerdjpzhz/
小儿营养不良性水肿	xeyyblxsz/
新生儿获得性免疫缺陷综合征	xsehdxmyqxzhz/
婴儿臀部肉芽肿	yetbryz/
婴幼儿脐疝	yyeqs/
鼻神经胶质瘤	bsjjzl/
慢性病贫血	mxbpx/
干眼	gy/
吉兰-巴雷综合征	jl_blzhz/
酒渣鼻样结核疹	jzbyjhz/
嗜酸细胞增多性复发性肉芽肿皮炎	ssxbzdxffxryzpy/
萎缩性毛周角化病	wsxmzjhb/
阿根廷出血热	agtcxr/
中毒性紫癜	zdxzd/
药物中毒性周围神经病	ywzdxzwsjb/
磨牙	my/
软产道异常性难产	rcdycxnc/
色汗症	shz/
硬化剂治疗引起的食管损害	yhjzlyqdsgsh/
II型糖尿病	iixtnb/
创伤后应激障碍	cshyjza/
代偿性多汗症	dcxdhz/
肺泡-毛细血管阻滞综合征	fp_mxxgzzzhz/
肺地丝菌病	fdsjb/
肺炎球菌脑膜炎	fyqjnmy/
肺青霉病	fqmb/
肺炎克雷白杆菌肺炎	fyklbgjfy/
肺疟疾病	fnjb/
肺损伤	fss_5012/
肺炎衣原体肺炎	fyyytfy/
肺癌皮肤转移	fapfzy/
呼吸性细支气管炎间质肺病	hxxxzqgyjzfb/
呼吸系统疾病伴发的精神障碍	hxxtjbbfdjsza/
军团菌肺炎	jtjfy/
结核性葡萄膜炎	jhxptmy/
金黄色葡萄球菌脑膜炎	jhsptqjnmy/
老年急性白血病	lnjxbxb/
免疫抑制药和抗癌药中毒性肾病	myyzyhkayzdxsb/
缺血性肠绞痛	qxxcjt/
Wegner肉芽肿伴发的葡萄膜炎	wegnerryzbfdptmy/
小儿金葡菌性烫伤样皮肤综合征	xejpjxtsypfzhz/
小儿肢端肥大症和垂体性巨人症	xezdfdzhctxjrz/
新生儿肺气漏	xsefql/
新生儿肝脾肿大	xsegpzd/
哮喘持续状态	xccxzt/
小儿哮喘性肌萎缩综合征	xexcxjwszhz/
休止期脱发	xzqtf/
腺病毒感染	xbdgr/
胸壁静脉炎	xbjmy/
阻塞性睡眠呼吸暂停综合征	zsxsmhxztzhz/
支气管哮喘	zqgxc/
白大衣高血压	bdygxy/
窦性心律失常	dxxlsc/
二尖瓣和主动脉瓣的疾患	ejbhzdmbdjh/
风湿性边缘性红斑	fsxbyxhb/
肥胖性生殖无能综合征	fpxszwnzhz/
高血压病伴发的精神障碍	gxybbfdjsza/
拔毛狂	bmk/
感染性心内膜炎肾损害	grxxnmyssh/
冠状病毒感染	gzbdgr/
甲亢合并妊娠	jkhbrs/
慢性附睾炎	mxfgy/
三尖瓣闭锁不全	sjbbsbq/
心肌梗死后心包炎	xjgshxby/
心包囊肿与心包憩室	xbnzyxbqs/
心包间皮瘤	xbjpl/
心包转移瘤	xbzyl/
胸锁关节脱位	xsgjtw/
心尖肥厚型心肌病	xjfhxxjb/
巴顿骨折	bdgz/
暴发性紫癜	bfxzd/
丙型肝炎病毒感染与肾小球肾炎	bxgybdgrysxqsy/
残胃淋巴瘤	cwlbl/
蛋白质-能量营养不良	dbz_nlyybl/
胆囊结石	dnjs/
胆源性急性胰腺炎	dyxjxyxy/
大肠平滑肌肉瘤	dcphjrl/
非甲状腺性的病态综合征	fjzxxdbtzhz/
肝结核	gjh/
肝上皮样血管内皮细胞瘤	gspyxgnpxbl/
肝小静脉闭塞症	gxjmbsz/
肝血管平滑肌脂肪瘤	gxgphjzfl/
黄杆菌肺炎	hgjfy/
结核性宫颈炎	jhxgjy/
急性化脓性关节炎	jxhnxgjy/
结肠平滑肌瘤	jcphjl/
急性细支气管炎	jxxzqgy/
急性附睾炎	jxfgy/
A-V综合征	a_vzhz/
酒精性脑萎缩	jjxnws/
结肠息肉和息肉病	jcxrhxrb/
结缔组织增生性毛发上皮瘤	jdzzzsxmfspl/
结直肠损伤	jzcss/
溃疡性结肠炎性关节炎	kyxjcyxgjy/
类癌综合征	lazhz/
阑尾类癌	lwla/
铅中毒引起的溶血性贫血	qzdyqdrxxpx/
胃肠道癌	wcda/
消化系统疾病伴发的精神障碍	xhxtjbbfdjsza/
细菌性心包炎	xjxxby/
原发性肝脂肪肉瘤	yfxgzfrl/
致死性家族性失眠症	zsxjzxsmz/
肩峰骨折	jfgz/
急性肾小球肾炎	jxsxqsy/
流行性出血性结膜炎	lxxcxxjmy/
狼疮样综合征	lcyzhz/
链球菌坏死	lqjhs/
类固醇5α-还原酶2缺乏综合征	lgc5_hym2qfzhz/
慢性化脓性鼻窦炎	mxhnxbdy/
母儿ABO血型不合	meaboxxbh/
慢性肾小球肾炎	mxsxqsy_5094/
膜增生性肾小球肾炎	mzsxsxqsy/
慢性嗜酸性粒细胞性肺炎	mxssxlxbxfy/
尿毒症肺炎	ndzfy/
尿布皮炎	nbpy/
尿道黏膜脱垂	ndnmtc/
膀胱移行细胞癌	bgyxxba/
膀胱白斑病	bgbbb/
溶血性链球菌性坏疽	rxxlqjxhj/
肾融合	srh/
肾静脉血栓	sjmxs/
输尿管脱垂	sngtc/
肾钙乳	sgr/
肾实质性高血压	sszxgxy/
肾盏积水	szjs/
肾盂输尿管连接部梗阻	sysngljbgz/
肾性氨基酸尿	sxajsn/
肾异位血管及副血管	sywxgjfxg/
肾动脉瘤	sdml/
糖尿病所致脊髓病	tnbszjsb/
微小病毒感染	wxbdgr/
小儿原发性纤毛运动障碍	xeyfxxmydza/
小儿慢性肾小球肾炎	xemxsxqsy/
小儿急性肾小球肾炎	xejxsxqsy/
原发性心脏横纹肌肉瘤	yfxxzhwjrl/
隐匿阴茎	ynyj/
耳真菌病	ezjb/
肝豆状核变性伴发的精神障碍	gdzhbxbfdjsza/
脑垂体功能异常伴发的精神障碍	nctgnycbfdjsza/
脑膨出	npc_5123/
脑梗死	ngs_5124/
糖尿病性肾病	tnbxsb/
小儿结核性心包炎	xejhxxby/
重症肌无力样综合征	zzjwlyzhz/
闭经溢乳综合征	bjyrzhz/
成人斯蒂尔病	crsdeb/
垂体卒中	ctzz/
带状角膜病变	dzjmbb/
甲状腺激素抵抗综合征	jzxjsdkzhz/
酒精伴发的精神障碍	jjbfdjsza/
巨人症与肢端肥大症	jrzyzdfdz/
甲状腺相关眼病	jzxxgyb/
甲状腺微小癌	jzxwxa/
继发性铁粒幼细胞性贫血	jfxtlyxbxpx/
假性醛固酮减少症	jxqgtjsz/
继发性女阴过度角化	jfxnygdjh/
颈部淋巴结转移癌	jblbjzya/
夸赛纳森林病	ksnslb/
淋巴瘤细胞白血病	lblxbbxb/
慢性黏膜皮肤念珠菌病	mxnmpfnzjb/
鞍上生殖细胞瘤	asszxbl/
脾大	pd/
妊娠合并宫颈癌	rshbgja/
嗜碱性粒细胞白血病	sjxlxbbxb/
糖尿病心肌病	tnbxjb/
胸腺囊肿	xxnz_5149/
亚急性结节性游走性脂膜炎	yjxjjxyzxzmy/
原发性乳腺恶性淋巴瘤	yfxrxexlbl/
原发性甲状旁腺功能亢进症与肾病	yfxjzpxgnkjzysb/
白血病伴发的精神障碍	bxbbfdjsza/
出血性脑梗死	cxxngs/
第Ⅰ型脊髓血管畸形	d_xjsxgjx/
多发性骨髓瘤病肾病	dfxgslbsb/
Jessner淋巴细胞浸润	jessnerlbxbjr/
氨气中毒	aqzd/
急性海绵窦栓塞性静脉炎	jxhmdssxjmy/
贫血伴发的精神障碍	pxbfdjsza/
缺铁性吞咽困难	qtxtykn/
溶血尿毒症综合征	rxndzzhz/
特发性震颤	tfxzc/
铁线虫病	txcb/
血小板无力症	xxbwlz/
血友病甲	xybj/
血管炎前期综合征	xgyqqzhz/
遗传性压力易感性周围神经病	ycxylygxzwsjb/
叶酸缺乏症	ysqfz/
营养障碍性多发性神经病	yyzaxdfxsjb/
真性小眼球	zxxyq/
干燥综合征神经系统损害	gzzhzsjxtsh/
类风湿性关节炎的肾损害	lfsxgjydssh/
硬皮病食管	ypbsg/
联合免疫缺陷病	lhmyqxb/
慢性血源性骨髓炎	mxxyxgsy/
梅克尔憩室	mkeqs/
慢性盆腔疼痛	mxpqtt/
查加斯病	cjsb/
蝶骨嵴脑膜瘤	dgjnml/
高血压性心肌病	gxyxxjb/
高血压脑出血	gxyncx/
脑膜炎奈瑟菌肺炎	nmynsjfy/
胆囊胆固醇沉着症	dndgcczz/
法布里病	fblb/
急性颈部软组织损伤	jxjbrzzss/
异物肉芽肿	ywryz/
胰腺肉瘤	yxrl/
胰腺分裂	yxfl/
非细菌性血栓性心内膜炎	fxjxxsxxnmy/
工业毒物中毒性周围神经病	gydwzdxzwsjb/
男性青春期发育延迟	nxqcqfyyc/
女性尿瘘	nxnl/
前葡萄膜炎	qptmy/
前列腺异位	qlxyw/
前列腺结石	qlxjs/
肾上腺意外瘤	ssxywl/
结肠黑变病	jchbb/
骨质软化症与佝偻病	gzrhzyglb/
维生素D依赖性佝偻病	wssdylxglb/
系统性血管炎	xtxxgy/
α1抗胰蛋白酶缺乏性肝病	1kydbmqfxgb/
皮肤脑膜瘤	pfnml/
脑动脉硬化伴发的精神障碍	ndmyhbfdjsza/
鼻咽癌的眼部病变	byadybbb/
戈登综合征	gdzhz/
甲状腺功能减低所致贫血	jzxgnjdszpx/
口腔癌皮肤转移	kqapfzy/
卵巢残余综合征	lccyzhz/
弥漫性婴儿纤维瘤病	mmxyexwlb/
皮肤白喉	pfbh/
宫颈妊娠	gjrs/
肱动脉损伤	gdmss/
卵巢黏液性肿瘤	lcnyxzl/
阿米巴性宫颈炎	ambxgjy/
卵巢巧克力囊肿破裂	lcqklnzpl/
卵巢支持-间质细胞瘤	lczc_jzxbl/
慢性髓细胞白血病	mxsxbbxb/
妊娠高血压疾病	rsgxyjb/
子宫复旧不全	zgfjbq/
妊娠合并肺栓塞	rshbfss/
妊娠合并甲状旁腺功能减退	rshbjzpxgnjt/
妊娠合并肠梗阻	rshbcgz/
结核性脑膜炎	jhxnmy/
精神发育迟缓	jsfych/
肝硬化性肾损害	gyhxssh/
淋病性关节炎	lbxgjy/
良性头部组织细胞增生症	lxtbzzxbzsz/
慢性纤维性甲状腺炎	mxxwxjzxy/
尿道综合征	ndzhz/
艾滋病人的急性阑尾炎	azbrdjxlwy/
病毒性脑膜炎	bdxnmy/
传染性单核细胞增多症	crxdhxbzdz/
地方性甲状腺肿	dfxjzxz/
肝纤维板层癌	gxwbca/
黑色棘皮症	hsjpz/
脑真菌性肉芽肿	nzjxryz/
伤寒性心肌炎	shxxjy/
伤口肉毒症	skrdz/
马尔堡病毒病	mebbdb/
陶瓷样胆囊	tcydn/
血吸虫病与肝胆疾病	xxcbygdjb/
剥脱综合征	btzhz_5243/
面红和面红恐惧症	mhhmhkjz/
毛发囊肿	mfnz/
甲真菌病	jzjb/
麻风性角膜病变	mfxjmbb/
甲状腺功能亢进性肝病	jzxgnkjxgb/
系统性红斑狼疮性巩膜炎	xtxhblcxgmy/
细粒棘球蚴病	xljqyb/
靶样含铁血黄素沉积性血管瘤	byhtxhscjxxgl/
结肠阿米巴	jcamb/
造口旁疝	zkps/
皮肌炎与多发性肌炎	pjyydfxjy/
暗色丝孢霉病	assbmb/
烧伤败血症	ssbxz/
宫颈微小型浸润癌	gjwxxjra/
条纹状苔藓	twztx/
遗传性乳腺癌-卵巢癌综合征	ycxrxa_lcazhz/
白塞病性巩膜炎	bsbxgmy/
白血病肾损害	bxbssh/
白血病视网膜病变	bxbswmbb/
败血症肾损害	bxzssh/
斑状白化病	bzbhb/
斑状萎缩	bzws/
瘢痕癌	bha/
板层状鱼鳞病	bczylb/
半月线疝	byxs/
半椎体畸形	bztjx/
伴齿状突骨折的寰枢椎前脱位	bcztgzdhszqtw/
伴纤维囊性骨炎的假性甲状旁腺功能低下症	bxwnxgydjxjzpxgndxz/
鲍恩病	beb/
鲍温样丘疹病	bwyqzb/
暴发性痤疮	bfxcc/
贝克痣	bkz/
背部弹力纤维瘤	bbdlxwl/
鼻部穿通性毛囊炎	bbctxmny/
鼻疽假单胞菌肺炎	bjjdbjfy/
鼻旁窦支气管综合征	bpdzqgzhz/
闭孔疝	bks/
闭塞性动脉硬化	bsxdmyh/
闭塞性血栓性脉管炎	bsxxsxmgy/
闭锁肺综合征	bsfzhz/
臂丛神经损伤	bcsjss/
变态反应性结膜炎	btfyxjmy/
变形杆菌肺炎	bxgjfy/
变性性近视的眼底损害	bxxjsdydsh/
变异型心绞痛	byxxjt/
变异型预激综合征	byxyjzhz/
变异性红斑角化病	byxhbjhb/
变应性皮肤血管炎	byxpfxgy/
表皮囊肿	bpnz/
表皮葡萄球菌肺炎	bpptqjfy/
表皮松解性棘皮瘤	bpsjxjpl/
表皮痣	bpz_5295/
宾斯旺格病	bswgb/
髌股关节软骨损伤	bggjrgss/
髌骨骨软骨病	bggrgb/
丙酮酸激酶缺乏症	btsjmqfz/
并发截瘫的脊柱结核	bfjtdjzjh/
并发症白内障	bfzbnz/
病毒性出血热	bdxcxr/
病毒性食管炎	bdxsgy/
玻璃体及视网膜脱离手术所致青光眼	bltjswmtlssszqgy/
剥脱性唇炎	btxcy/
播散性复发性漏斗部毛囊炎	bsxffxldbmny/
播散性黄瘤伴尿崩症	bsxhlbnbz/
播散性嗜酸粒细胞增多性胶原病	bsxsslxbzdxjyb/
播散性血管内凝血	bsxxgnnx/
勃起功能障碍	bqgnza/
不安腿综合征	batzhz/
不动杆菌肺炎	bdgjfy/
不动杆菌感染	bdgjgr/
不动纤毛综合征	bdxmzhz/
不稳定型心绞痛	bwdxxjt/
不稳定血红蛋白病	bwdxhdbb/
布氏杆菌性关节炎	bsgjxgjy/
布氏菌病	bsjb/
布氏菌肺炎	bsjfy/
步态异常	btyc/
C5功能不全综合征	c5gnbqzhz/
Castleman病	castlemanb/
CD30阳性皮肤T细胞淋巴瘤	cd30yxpftxblbl/
Chance骨折	chancegz/
CM1神经节苷脂贮积症	cm1sjjgzzjz/
残胃平滑肌肉瘤	cwphjrl/
苍白球黑质红核色素变性	cbqhzhhssbx/
茶毛虫皮炎	cmcpy/
产后精神病	chjsb/
产后泌尿道感染	chmndgr/
产后虚脱	chxt/
产后抑郁症	chyyz/
产碱杆菌肺炎	cjgjfy/
产科播散性血管内凝血	ckbsxxgnnx/
产科休克	ckxk/
产力异常性难产	clycxnc/
长骨骨干结核	cgggjh/
长骨造釉细胞瘤	cgzyxbl/
长膜壳绦虫病	cmktcb/
肠白塞病	cbsb/
肠病性肢端皮炎	cbxzdpy/
肠出血性大肠埃希杆菌感染	ccxxdcaxgjgr/
肠道病毒71型感染	cdbd71xgr/
肠道感染后反应性关节炎	cdgrhfyxgjy/
肠道革兰阴性杆菌脑膜炎	cdglyxgjnmy/
肠道血管畸形	cdxgjx/
肠毒性大肠埃希杆菌感染	cdxdcaxgjgr/
肠杆菌肺炎	cgjfy/
肠毛滴虫病	cmdcb/
肠球菌肺炎	cqjfy/
肠伤寒穿孔	cshck/
肠石性肠梗阻	csxcgz/
肠系膜静脉血栓形成	cxmjmxsxc/
肠系膜裂孔疝	cxmlks/
肠系膜肿瘤	cxmzl/
尘螨过敏性哮喘	cmgmxxc/
成人腹股沟斜疝	crfggxs/
成人骨坏死	crghs/
成人型慢性粒细胞白血病	crxmxlxbbxb/
成人型女性乳房肥大症	crxnxrffdz/
成人痒疹	cryz/
成人硬肿症	cryzz/
迟发性外伤性脑内血肿	cfxwsxnnxz/
迟发性运动障碍	cfxydza/
持久性豆状角化过度病	cjxdzjhgdb/
持久性隆起性红斑	cjxlqxhb/
持久性色素异常性红斑	cjxssycxhb/
持续性交接区折返性心动过速	cxxjjqzfxxdgs/
持续性输卵管妊娠	cxxslgrs/
持续性枕横位难产	cxxzhwnc_5370/
持续性肢皮炎	cxxzpy/
持续性植物状态	cxxzwzt/
尺骨干骨折	cgggz/
耻骨直肠肌综合征	cgzcjzhz/
充血性心力衰竭	cxxxlsj/
冲浪者结节	clzjj/
虫霉病	cmb/
抽动秽语综合征	cdhyzhz/
臭汗恐惧症	chkjz/
臭汗症	chz/
出血败血性巴斯德菌感染	cxbxxbsdjgr/
出血性膀胱炎	cxxbgy/
出血性输卵管炎	cxxslgy/
创伤性骨化性肌炎	csxghxjy/
创伤性骨髓炎	csxgsy/
创伤性关节炎	csxgjy/
创伤性肩关节后脱位	csxjgjhtw/
创伤性休克	csxxk/
创伤性血胸	csxxx/
春季结膜炎	cjjmy/
催乳素瘤	crsl/
脆甲症	cjz/
髂静脉压迫综合征	qjmypzhz/
重复膀胱	zfbg/
重复尿道	zfnd/
重复阴茎	zfyj/
DF-2败血症的皮肤表现	df_2bxzdpfbx/
δ-贮存池病	_zccb_5398/
大肠埃希杆菌性胃肠炎	dcaxgjxwcy/
大肠脂肪瘤	dczfl/
大动脉炎	ddmy/
大颗粒淋巴细胞白血病	dkllbxbbxb/
大脑镰旁脑膜瘤	dnlpnml/
大脑凸面脑膜瘤	dntmnml/
大网膜肿瘤	dwmzl/
代谢性白内障	dxxbnz/
带状疱疹性角膜炎	dzpzxjmy/
单侧肺气肿	dcfqz/
单纯疱疹病毒肺炎	dcpzbdfy/
单纯疱疹性葡萄膜炎	dcpzxptmy/
单纯肾异位	dcsyw/
单纯性肺嗜酸性粒细胞增多症	dcxfssxlxbzdz/
单纯性寰枢椎脱位	dcxhsztw/
单纯性脊柱结核	dcxjzjh/
单纯性肾囊肿	dcxsnz/
单房性骨囊肿	dfxgnz/
单核细胞白血病	dhxbbxb/
单克隆丙种球蛋白病伴周围神经病	dklbzqdbbbzwsjb/
单神经病与神经丛神经病	dsjbysjcsjb/
单眼双下转肌麻痹	dysxzjmb/
胆肠内引流术后内疝	dcnylshns/
胆道运动功能障碍	ddydgnza/
胆固醇脓胸	dgcnx/
胆囊类癌	dnla/
胆囊良性肿瘤	dnlxzl/
胆囊平滑肌肉瘤	dnphjrl/
胆源性慢性胰腺炎	dyxmxyxy/
蛋白丢失性胃肠病	dbdsxwcb/
稻农皮炎	dnpy/
登革出血热	dgcxr/
低镁血症	dmxz/
低钠血症	dnxz/
低血压	dxy/
迪格奥尔格综合征	dgaegzhz/
骶骨骨折	dggz/
地方性克汀病	dfxktb/
地霉菌病	dmjb/
第Ⅱ、Ⅲ型脊髓血管畸形	d___xjsxgjx/
第3腰椎横突过长畸形	d3yzhtgcjx/
第Ⅳ型脊髓血管畸形	d_xjsxgjx_5440/
第一掌骨基底部骨折脱位	dyzgjdbgztw/
癫痫发作与癫痫综合征	dxfzydxzhz/
癫痫性精神障碍	dxxjsza/
典型预激综合征	dxyjzhz/
碘源性甲亢	dyxjk/
淀粉样变病和淀粉样关节病	dfybbhdfygjb/
淀粉样变心肌病	dfybxjb/
淀粉样变性	dfybx/
淀粉样变性周围神经病	dfybxzwsjb/
叠瓦癣	dwx/
蝶骨嵴脑膜瘤眼部病变	dgjnmlybbb/
蝶骨脑膜瘤的眼眶病变	dgnmldykbb/
冬季瘙痒症	djsyz/
冬眠瘤	dml_5454/
动静脉血管瘤	djmxgl/
窦房传导阻滞	dfcdzz/
窦房折返性心动过速	dfzfxxdgs/
窦室传导	dscd/
窦性期前收缩	dxqqss/
窦性组织细胞增生伴巨大淋巴结病	dxzzxbzsbjdlbjb/
毒性弥漫性甲状腺肿	dxmmxjzxz/
毒鱼刺伤	dycs/
杜波组织胞浆菌病	dbzzbjjb/
短P-R综合征	dp_rzhz/
短肠综合征	dczhz/
短骨骨干结核	dgggjh/
短腰畸形	dyjx/
短暂性大脑缺血性发作	dzxdnqxxfz/
短暂性棘皮松解皮肤病	dzxjpsjpfb/
对称性进行性红斑角化症	dcxjxxhbjhz/
多巴反应性肌张力障碍	dbfyxjzlza/
多发性斑状色素沉着症	dfxbzssczz/
多发性肌炎-皮肌炎	dfxjy_pjy/
多房棘球蚴病	dfjqyb/
多睾症	dgz/
多骨纤维发育不良	dgxwfybl/
多杀巴斯德杆菌病	dsbsdgjb/
多肾盏畸形	dszjx/
多系统器官功能衰竭	dxtqggnsj/
多系统萎缩	dxtws/
多源性房性心动过速	dyxfxxdgs/
多灶性脉络膜炎伴全葡萄膜炎	dzxmlmybqptmy/
多灶性运动神经病	dzxydsjb/
多指畸形	dzjx/
多中心性网状组织细胞增生症	dzxxwzzzxbzsz/
Ⅱ型免疫母细胞性淋巴腺病	_xmymxbxlbxb_5486/
EB病毒感染	ebbdgr/
额外肾	ews/
额叶癫痫	eydx/
恶心和呕吐	exhot/
恶性高血压	exgxy/
恶性高血压视网膜病变	exgxyswmbb/
恶性蓝痣	exlz/
恶性脑膜瘤	exnml/
恶性萎缩性丘疹病	exwsxqzb/
恶性小汗腺螺旋腺瘤	exxhxlxxl/
恶性胸腔积液	exxqjy/
恶性血管内皮细胞瘤	exxgnpxbl/
恶性营养不良病	exyyblb/
恶性肿瘤所致贫血	exzlszpx/
鳄皮婴儿综合征	epyezhz/
二度房室传导阻滞	edfscdzz/
二尖瓣、主动脉瓣和三尖瓣的合并疾患	ejb_zdmbhsjbdhbjh/
二尖瓣闭锁不全	ejbbsbq/
二氧化氮中毒	eyhdzd/
二氧化硫中毒	eyhlzd/
淋巴癌	lba/
颞叶癫痫	nydx/
发疱性甲虫皮炎	fpxjcpy/
发疹性毳毛囊肿	fzxcmnz/
发作性嗜睡强食综合征	fzxssqszhz/
发作性睡病	fzxsb/
反射性交感神经营养不良综合征	fsxjgsjyyblzhz/
反射性躯体神经病	fsxqtsjb/
躯体性神经病	qtxsjb/
反向斜视	fxxs/
反应性穿孔性胶原病	fyxckxjyb/
反应性浆细胞增多症	fyxjxbzdz/
泛发性扁平黄色瘤	ffxbphsl/
泛发性毛囊错构瘤	ffxmncgl/
泛发性特发性毛细血管扩张	ffxtfxmxxgkz/
范科尼综合征	fknzhz/
房间隔缺损	fjgqs/
房室交接区逸搏和逸搏心律	fsjjqybhybxl/
房室结折返性心动过速	fsjzfxxdgs/
房室折返性心动过速	fszfxxdgs/
房性期前收缩	fxqqss/
房性心动过速伴房室传导阻滞	fxxdgsbfscdzz/
房性逸搏和房性逸搏心律	fxybhfxybxl/
放射性甲状腺炎	fsxjzxy/
放射性皮炎	fsxpy/
放射性肾炎	fsxsy/
放射性食管炎	fsxsgy/
放射性视网膜病变	fsxswmbb/
放射性心包炎	fsxxby/
放射性心脏损害	fsxxzsh/
放射性周围神经病	fsxzwsjb/
非闭塞性肠系膜血管缺血	fbsxcxmxgqx/
非哺乳期乳晕部瘘管	fbrqryblg/
非典型麻疹综合征	fdxmzzhz/
非典型纤维黄色瘤	fdxxwhsl/
非结核分枝杆菌病	fjhfzgjb/
非结核分枝杆菌性角膜炎	fjhfzgjxjmy/
非结核性分枝杆菌病	fjhxfzgjb/
非结核性分枝杆菌关节炎	fjhxfzgjgjy/
非肾上腺素增生性假两性畸形	fssxszsxjlxjx/
非梭状芽胞杆菌肌坏死	fszybgjjhs/
非特异性间质肺炎	ftyxjzfy/
非性病性梅毒	fxbxmd/
非甾体类抗炎药物性肾病	fztlkyywxsb/
非阵发性窦性心动过速	fzfxdxxdgs/
非阵发性交接区性心动过速	fzfxjjqxxdgs/
非洲锥虫病	fzzcb/
肥大细胞白血病	fdxbbxb/
肥大性脊椎炎	fdxjzy/
肥胖性心肌病	fpxxjb/
肺不发育或发育不全	fbfyhfybq/
肺不张	fbz/
肺部粪类圆线虫病	fbflyxcb/
肺部钩虫病	fbgcb/
肺部良性肿瘤	fblxzl/
肺部少见的恶性肿瘤	fbsjdexzl/
肺淀粉样变性	fdfybx/
肺动脉高压	fdmgy/
肺弓形体病	fgxtb/
肺宫崎肺吸虫症	fgqfxcz/
肺蛔虫病	fhcb/
肺棘球蚴病	fjqyb/
肺荚膜组织胞浆菌病	fjmzzbjjb/
肺假性淋巴瘤	fjxlbl/
肺良性淋巴细胞血管炎和肉芽肿病	flxlbxbxgyhryzb/
肺螨病	fmb/
肺毛霉病	fmmb/
肺囊性纤维化	fnxxwh/
肺诺卡菌病	fnkjb/
肺泡通气低下综合征	fptqdxzhz/
肺泡微结石症	fpwjsz/
肺球孢子菌病	fqbzjb_5578/
肺嗜酸细胞组织细胞增生症	fssxbzzxbzsz/
肺嗜酸性粒细胞浸润症	fssxlxbjrz/
肺鼠疫	fsy/
肺炭疽	ftj/
肺血管炎	fxgy/
肺血吸虫病	fxxcb/
肺芽生菌病	fysjb/
肺炎链球菌败血症	fylqjbxz/
肺炎链球菌性肺炎	fylqjxfy/
肺炎衣原体感染	fyyytgr/
肺组织细胞增生症	fzzxbzsz/
费尔蒂综合征	fedzhz/
痱	f/
奋森咽峡炎	fsyxy/
匐行性脉络膜炎	fxxmlmy/
匐行疹	fxz/
辐射性白内障	fsxbnz/
妇产科静脉血栓病	fckjmxsb/
妇女多毛症	fndmz/
妇女雄激素源性秃发	fnxjsyxtf/
附睾畸形	fgjx/
复发性多发性软骨炎伴发的葡萄膜炎	ffxdfxrgybfdptmy/
复发性多软骨炎	ffxdrgy/
复发性多软骨炎性巩膜炎	ffxdrgyxgmy/
复发性风湿病	ffxfsb/
复发性腹股沟疝	ffxfggs/
复发性腹膜后肿瘤	ffxfmhzl/
复发性坏死性黏膜周围炎	ffxhsxnmzwy/
复发性溃疡	ffxky/
复发性卵巢恶性肿瘤	ffxlcexzl/
复发性皮肤坏死性嗜酸粒细胞血管炎	ffxpfhsxsslxbxgy/
复发性外阴阴道念珠菌病	ffxwyydnzjb/
复发性无菌性脑膜炎	ffxwjxnmy/
复发性线性棘层松解性皮肤病	ffxxxjcsjxpfb/
副鼻窦炎	fbdy/
副流行性感冒	flxxgm/
副伤寒	fsh/
副神经节起源的肿瘤	fsjjqydzl/
副神经损伤	fsjss/
副神经损伤与卡压	fsjssyky/
副银屑病	fyxb/
副肿瘤性边缘系统脑炎	fzlxbyxtny/
副肿瘤性脊髓病	fzlxjsb/
副肿瘤性小脑变性	fzlxxnbx/
副肿瘤性斜视性眼肌阵挛-肌阵挛	fzlxxsxyjzl_jzl/
腹壁挫伤	fbcs_5624/
腹壁坏死性筋膜炎	fbhsxjmy/
腹壁间疝	fbjs/
腹壁血栓性静脉炎	fbxsxjmy/
腹壁硬纤维瘤	fbyxwl/
腹部肿块	fbzk/
腹股沟滑动疝	fgghds/
腹股沟滑动性疝	fgghdxs/
腹腔干动脉瘤	fqgdml/
腹腔室隔综合征	fqsgzhz/
腹水	fs_5634/
腹直肌鞘内血肿	fzjqnxz/
腹直肌自发性破裂	fzjzfxpl/
腹主动脉动脉瘤破裂	fzdmdmlpl/
腹主动脉瘤	fzdml/
腹主动脉腔静脉瘘	fzdmqjml/
腹主动脉缩窄	fzdmsz/
葡萄糖磷酸异构酶缺乏症	pttlsygmqfz/
甘露糖苷贮积症	gltgzjz/
杆菌性上皮样血管瘤病	gjxspyxglb/
肝大	gd/
肝淀粉样变性	gdfybx/
肝动脉闭塞	gdmbs/
肝动脉瘤	gdml_5647/
肝肺综合征	gfzhz_5648/
肝母细胞瘤	gmxbl_5649/
肝素诱导性血小板减少症	gsydxxxbjsz/
肝性卟啉病	gxblb/
肝血管肉瘤	gxgrl/
肝炎病毒相关风湿病	gybdxgfsb/
肝脏局灶性结节性增生	gzjzxjjxzs/
肝脏类癌	gzla/
肝脏外伤	gzws/
肝脏血管瘤	gzxgl/
肝脏炎性假瘤	gzyxjl/
肝肿瘤	gzl_5659/
肝紫癜病	gzdb/
感染性疾病所致贫血	grxjbszpx/
感应性妄想性障碍	gyxwxxza/
肛管内括约肌痉挛性收缩	ggnkyjjlxss/
肛管损伤	ggss/
肛管直肠恶性黑色素瘤	ggzcexhssl/
肛管直肠周围脓肿	ggzczwnz/
高催乳素血症	gcrsxz/
高碘性甲状腺肿	gdxjzxz/
高动力性循环	gdlxxh/
高度房室传导阻滞	gdfscdzz/
高钙血症	ggxz/
高钙血症肾病	ggxzsb/
高镁血症	gmxz/
高钠血症	gnxz/
高渗性非酮症高血糖昏迷	gsxftzgxthm/
高渗性非酮症糖尿病昏迷	gsxftztnbhm/
高血压病视网膜病变	gxybswmbb/
高原肺水肿	gyfsz/
高原红细胞增多症	gyhxbzdz/
高原脑水肿	gynsz/
高脂蛋白血症	gzdbxz/
高脂蛋白血症Ⅰ型	gzdbxz_x/
高脂蛋白血症Ⅱ型	gzdbxz_x_5683/
高脂蛋白血症Ⅲ型	gzdbxz_x_5684/
高脂蛋白血症Ⅳ型	gzdbxz_x_5685/
高脂蛋白血症Ⅴ型	gzdbxz_x_5686/
高脂血症	gzxz/
高致病性禽流感病毒感染	gzbxqlgbdgr/
睾丸淋巴瘤	gwlbl/
睾丸损伤	gwss/
格子状角膜营养不良	gzzjmyybl/
工业中毒所致的精神障碍	gyzdszdjsza/
弓形体病性巩膜炎	gxtbxgmy/
肱二头肌长头腱鞘炎	getjctjqy/
肱骨大结节骨折	ggdjjgz/
肱骨头骨折	ggtgz_5696/
宫颈浸润癌	gjjra/
宫颈上皮内瘤变	gjspnlb/
宫腔积脓	gqjn/
钩端螺旋体病神经系统表现	gdlxtbsjxtbx/
钩端螺旋体肺炎	gdlxtfy/
枸橼酸杆菌肺炎	gysgjfy/
股动脉损伤	gdmss_5703/
股骨转子下骨折	ggzzxgz/
股神经卡压综合征	gsjkyzhz/
股神经损伤	gsjss/
股四头肌肌腱断裂	gstjjjdl/
股外侧皮神经卡压综合征	gwcpsjkyzhz/
股外侧皮神经炎	gwcpsjy/
股癣	gx_5710/
骨恶性纤维组织细胞瘤	gexxwzzxbl/
骨神经纤维瘤	gsjxwl/
骨嗜酸性肉芽肿	gssxryz/
骨髓病性贫血	gsbxpx/
骨血管肉瘤	gxgrl_5715/
骨血管外皮细胞瘤	gxgwpxbl/
鼓膜穿孔	gmck/
冠状动脉瘤	gzdml/
冠状动脉异常起源于肺动脉	gzdmycqyyfdm/
冠状动脉异常起源主动脉	gzdmycqyzdm/
管状小汗腺癌	gzxhxa/
光气中毒	gqzd/
光线性弹力纤维病	gxxdlxwb/
光泽苔藓	gztx/
广泛性焦虑障碍	gfxjlza/
广州管圆线虫病	gzgyxcb/
龟分枝杆菌感染	gfzgjgr/
龟头炎	gty/
腘动脉瘤	gdml_5729/
腘动脉破裂	gdmpl/
过度通气综合征	gdtqzhz/
过敏性肉芽肿性血管炎相关巩膜炎	gmxryzxxgyxggmy/
过敏性血管炎和肉芽肿病	gmxxgyhryzb/
过敏性阴道炎	gmxydy/
过敏性支气管肺曲霉病	gmxzqgfqmb/
HIV相关呼吸道感染	hivxghxdgr/
Hughes-Stovin综合征	hughes_stovinzhz/
非火器性颅脑开放伤	fhqxlnkfs/
海胆刺伤及海胆肉芽肿	hdcsjhdryz/
海洛因肾脏病	hlyszb/
海绵状血管瘤血小板减少综合征	hmzxglxxbjszhz/
海鱼分枝杆菌感染	hyfzgjgr/
寒冷性脂膜炎	hlxzmy/
汉德-许勒尔-克思斯琴病	hd_xle_kssqb/
汉坦病毒肺综合征	htbdfzhz/
汗管棘皮瘤	hgjpl/
汗孔周围炎及多发性汗腺脓肿	hkzwyjdfxhxnz/
汗疱症	hpz/
汗腺癌	hxa/
合并马蹄肾的腹主动脉瘤	hbmtsdfzdml/
合成树脂皮炎	hcszpy/
合成树脂与塑料所致的皮肤病	hcszyslszdpfb/
黑棘皮瘤	hjpl/
黑色丘疹性皮肤病	hsqzxpfb/
黑癣	hx/
亨廷顿病	htdb/
亨廷顿病性痴呆	htdbxcd/
横位难产	hwnc/
红细胞生成性原卟啉病	hxbscxyblb/
红细胞增多症视网膜病变	hxbzdzswmbb/
红细胞增多症眼底	hxbzdzyd/
红癣	hx_5762/
虹膜角膜内皮综合征	hmjmnpzhz/
虹膜新生血管	hmxsxg/
喉返神经损伤	hfsjss/
后壁穿孔性溃疡	hbckxky/
后部多形性角膜营养不良	hbdxxjmyybl/
后发性白内障	hfxbnz/
后十字韧带损伤	hszrdss/
后天性大疱性表皮松解	htxdpxbpsj/
胡桃夹食管	htjsg/
华支睾吸虫病	hzgxcb/
滑脱性肋骨综合征	htxlgzhz/
化脓性腱鞘炎	hnxjqy/
化脓性颅骨骨髓炎	hnxlggsy/
化脓性门静脉炎	hnxmjmy/
化脓性脑膜炎	hnxnmy/
化脓性盆腔血栓静脉炎	hnxpqxsjmy/
化脓性眼内炎	hnxyny/
化脓性指头炎	hnxzty/
化妆品皮炎	hzppy/
踝关节骨折	hgjgz/
踝关节结核	hgjjh/
踝关节脱位	hgjtw/
坏死性结节病样肉芽肿病	hsxjjbyryzb/
坏死性筋膜炎	hsxjmy/
环状红斑	hzhb/
环状外阴炎	hzwyy/
寰椎骨折	hzgz/
黄斑囊样水肿	hbnysz/
黄色瘤	hsl/
黄色肉芽肿性肾盂肾炎	hsryzxsysy/
黄体囊肿	htnz/
灰泥角化病	hnjhb/
回旋状脉络膜视网膜萎缩	hxzmlmswmws/
蛔虫性急性胰腺炎	hcxjxyxy/
会阴下降综合征	hyxjzhz/
混合型卟啉病	hhxblb/
混合型慢性高原病	hhxmxgyb/
混合型肾小管性酸中毒	hhxsxgxszd/
混合性结缔组织病	hhxjdzzb/
火器性颅脑损伤	hqxlnss/
获得性高脂蛋白血症	hdxgzdbxz/
获得性免疫缺陷综合征	hdxmyqxzhz/
获得性免疫缺陷综合征的神经系统表现	hdxmyqxzhzdsjxtbx/
获得性免疫缺陷综合征的消化系统损害	hdxmyqxzhzdxhxtsh/
获得性免疫缺陷综合征的心血管损害	hdxmyqxzhzdxxgsh/
获得性免疫缺陷综合征视网膜病变	hdxmyqxzhzswmbb/
获得性免疫缺陷综合征相关淋巴瘤	hdxmyqxzhzxglbl/
获得性视网膜大动脉瘤	hdxswmddml/
获得性视网膜劈裂	hdxswmpl/
获得性维生素K依赖性凝血因子异常	hdxwsskylxnxyzyc/
肌病肾病性代谢综合征	jbsbxdxzhz/
肌疝	js/
肌阵挛性小脑协调障碍	jzlxxnxdza/
基底核钙化症	jdhghz/
激素抵抗型哮喘	jsdkxxc/
极外侧型腰椎间盘突出症	jwcxyzjptcz/
急进性肾小球肾炎	jjxsxqsy/
急性肠系膜上动脉梗死	jxcxmsdmgs/
急性肠系膜上动脉栓塞或血栓形成	jxcxmsdmsshxsxc/
急性肠系膜上静脉血栓形成	jxcxmsjmxsxc/
急性非特异性睾丸炎	jxftyxgwy/
急性附件炎	jxfjy/
急性梗阻性化脓性胆管炎	jxgzxhnxdgy/
急性化脓性脊髓炎	jxhnxjsy/
急性化脓性甲状腺炎	jxhnxjzxy/
急性间质性肺炎	jxjzxfy/
急性减压性骨坏死	jxjyxghs/
急性弥漫性腹膜炎	jxmmxfmy/
急性糜烂性胃炎	jxmlxwy/
急性脑内血肿	jxnnxz/
急性盆腔炎	jxpqy/
急性气管支气管炎	jxqgzqgy/
急性全自主神经失调症	jxqzzsjsdz/
急性乳突炎	jxrty/
急性视网膜色素上皮炎	jxswmssspy/
急性嗜酸性粒细胞性肺炎	jxssxlxbxfy/
急性髓细胞白血病	jxsxbbxb/
急性特发性心包炎	jxtfxxby/
急性妄想发作	jxwxfz/
急性右侧心力衰竭	jxycxlsj/
急性杂合性白血病	jxzhxbxb/
急性早幼粒细胞白血病	jxzylxbbxb/
急性脂肪皮肤硬化症	jxzfpfyhz/
急性左侧心力衰竭	jxzcxlsj/
疾病恐怖	jbkb/
棘阿米巴性巩膜炎	jambxgmy/
棘阿米巴性角膜炎	jambxjmy/
棘球蚴病	jqyb/
棘上韧带损伤	jsrdss/
集聚肠杆菌感染	jjcgjgr/
己糖激酶缺乏症	jtjmqfz/
挤奶者结节	jnzjj/
脊膜膨出与脊膜脊髓膨出	jmpcyjmjspc/
脊髓海绵状血管瘤	jshmzxgl/
脊髓后动脉缺血症候群	jshdmqxzhq/
脊髓内出血	jsncx/
脊髓内脓肿	jsnnz/
脊髓前动脉综合征	jsqdmzhz/
脊髓前中央动脉缺血症候群	jsqzydmqxzhq/
脊髓缺血	jsqx/
脊髓刃器伤	jsrqs/
脊髓神经鞘瘤	jssjql/
脊髓栓系综合征	jssxzhz/
脊髓性肌萎缩	jsxjws/
脊柱脊髓损伤	jzjsss/
继发性单克隆免疫球蛋白病	jfxdklmyqdbb/
继发性腹膜炎	jfxfmy/
继发性骨髓纤维化	jfxgsxwh/
继发性红细胞增多症	jfxhxbzdz/
继发性化脓性腹膜炎	jfxhnxfmy/
继发性皮肤CD30阳性大细胞淋巴瘤	jfxpfcd30yxdxblbl/
继发性皮肤滤泡中心细胞性淋巴瘤	jfxpflpzxxbxlbl/
继发性痛经	jfxtj/
继发性系统性淀粉样变	jfxxtxdfyb/
继发性血小板增多症	jfxxxbzdz/
继发性粘连性蛛网膜炎	jfxzlxzwmy/
继发于严重肝疾患的棘红细胞增多症	jfyyzgjhdjhxbzdz/
寄生虫妄想	jscwx/
寄生虫性关节炎	jscxgjy/
寄生虫性尿路感染	jscxnlgr/
加利福尼亚脑炎	jlfnyny/
加速性房性逸搏心律	jsxfxybxl/
加速性室性自主心律	jsxsxzzxl/
家族性出血性肾炎	jzxcxxsy/
家族性地中海热	jzxdzhr/
家族性高胆固醇血症	jzxgdgcxz/
家族性红细胞增多症	jzxhxbzdz/
家族性混合型高脂血症	jzxhhxgzxz/
家族性甲状腺非髓样癌	jzxjzxfsya/
家族性抗维生素D佝偻病	jzxkwssdglb/
家族性良性天疱疮	jzxlxtpc/
家族性黏液血管纤维瘤	jzxnyxgxwl/
家族性渗出性玻璃体视网膜病变	jzxscxbltswmbb/
家族性异常β脂蛋白血症	jzxyczdbxz/
家族性载脂蛋白B100缺陷症	jzxzzdbb100qxz/
荚膜组织胞浆菌病	jmzzbjjb/
甲亢性心脏病	jkxxzb/
甲良性肿瘤	jlxzl/
甲内型甲真菌病	jnxjzjb/
甲下外生骨疣	jxwsgy/
甲型病毒性肝炎	jxbdxgy/
甲状旁腺功能减退性心肌病	jzpxgnjtxxjb/
甲状旁腺功能减退症	jzpxgnjtz/
甲状旁腺功能亢进性心肌病	jzpxgnkjxxjb/
甲状旁腺功能异常伴发的精神障碍	jzpxgnycbfdjsza/
甲状腺功能减退症	jzxgnjtz/
甲状腺功能亢进性骨矿疾病	jzxgnkjxgkjb/
甲状腺功能亢进性心肌病	jzxgnkjxxjb/
甲状腺功能亢进症的肾损害	jzxgnkjzdssh/
甲状腺功能异常伴发的精神障碍	jzxgnycbfdjsza/
甲状腺结核	jzxjh/
贾第虫病	jdcb/
假斑秃	jbt/
假性高血压	jxgxy/
假性黑棘皮病	jxhjpb/
肩峰下撞击征	jfxzjz/
肩关节不稳定	jgjbwd/
肩胛背神经卡压症	jjbsjkyz/
肩胛骨体部骨折	jjgtbgz/
肩胛颈及肩胛盂骨折	jjjjjjygz/
肩胛上神经卡压症	jjssjkyz/
肩袖间隙分裂	jxjxfl/
肩袖损伤	jxss/
睑球粘连	jqzl/
腱鞘巨细胞瘤	jqjxbl/
腱鞘囊肿	jqnz/
交叉性异位肾	jcxyws/
交感神经链综合征	jgsjlzhz/
胶质母细胞瘤	jzmxbl/
角层下脓疱性皮肤病	jcxnpxpfb/
角化棘皮瘤	jhjpl/
角膜鳞状细胞癌	jmlzxba/
脚癣	jx_5935/
接触性唇炎	jcxcy/
节段性透明性血管炎	jdxtmxxgy/
洁癖	jp/
结肠类癌	jcla/
结肠破裂	jcpl/
结肠血管畸形	jcxgjx/
结肠血管扩张症	jcxgkzz/
结核性巩膜炎	jhxgmy/
结核性脊髓炎	jhxjsy/
结核性角膜病变	jhxjmbb/
结核性胸膜炎	jhxxmy/
结核性阴道炎	jhxydy/
结节性脆发病	jjxcfb/
结节性多动脉炎性巩膜炎	jjxddmyxgmy/
结节性筋膜炎	jjxjmy/
结节性血管炎	jjxxgy/
结节性痒疹	jjxyz/
结节性脂肪坏死	jjxzfhs/
结直肠血管瘤	jzcxgl/
睫状环阻滞性青光眼	jzhzzxqgy/
睫状体黑色素瘤	jzthssl/
戒酒综合征	jjzhz/
金黄色葡萄球菌性边缘性角膜炎	jhsptqjxbyxjmy/
金属性变色	jsxbs/
金属引起的口腔黏膜疾病	jsyqdkqnmjb/
筋膜间隔区综合征	jmjgqzhz/
近视	js_5962/
进行性骨干发育不良	jxxggfybl/
进行性肌营养不良症	jxxjyyblz/
进行性色素性紫癜性皮病	jxxssxzdxpb/
进行性脂肪营养不良	jxxzfyybl/
浸渍足	jzz/
经膈肌肋间疝	jgjljs/
晶状体膨胀所致青光眼	jztpzszqgy/
晶状体溶解性青光眼	jztrjxqgy/
晶状体脱位所致青光眼	jzttwszqgy/
晶状体相关葡萄膜炎	jztxgptmy/
晶状体异位	jztyw/
精囊恶性肿瘤	jnexzl/
精囊结石	jnjs/
精囊囊肿	jnnz/
颈部脊髓损伤	jbjsss/
颈部开放性损伤	jbkfxss/
颈部勒伤	jbls/
颈部血管瘤	jbxgl/
颈部血管损伤	jbxgss/
颈丛神经卡压症	jcsjkyz/
颈动脉创伤性栓塞	jdmcsxss/
颈动脉窦综合征	jdmdzhz/
颈动脉海绵窦瘘	jdmhmdl/
颈动脉狭窄	jdmxz/
颈静脉球瘤	jjmql/
颈肋	jl/
颈肋畸形	jljx/
颈神经背支卡压症	jsjbzkyz/
颈型颈椎病	jxjzb/
颈腰综合征	jyzhz_5992/
颈椎骨折伴脱位的损伤	jzgzbtwdss/
颈椎椎体楔形压缩骨折	jzztxxysgz/
胫骨后唇骨折	jghcgz/
胫骨应力骨折	jgylgz/
胫骨远端爆裂骨折	jgydblgz/
胫后神经损伤	jhsjss/
痉挛性肠梗阻	jlxcgz/
痉挛性脑瘫	jlxnt/
静脉血栓形成	jmxsxc/
静脉炎	jmy/
酒精性弱视	jjxrs/
酒精中毒性神经疾病	jjzdxsjjb/
酒中毒性痴呆	jzdxcd/
酒中毒性小脑变性	jzdxxnbx/
酒中毒性周围神经病	jzdxzwsjb/
局限性硬皮病	jxxypb/
局灶性节段性肾小球硬化	jzxjdxsxqyh/
巨大裂孔性视网膜脱离	jdlkxswmtl/
巨大胎儿	jdte/
巨大血小板病	jdxxbb/
巨乳头性结膜炎	jrtxjmy/
巨舌	js_6014/
巨吻棘头虫病	jwjtcb/
巨细胞病毒病	jxbbdb/
巨细胞病毒性葡萄膜炎	jxbbdxptmy/
巨细胞动脉炎性巩膜炎	jxbdmyxgmy/
绝经	jj/
绝经后骨质疏松	jjhgzss/
绝经后卵巢恶性肿瘤	jjhlcexzl/
绝经后子宫颈癌	jjhzgja/
绝经后子宫内膜癌	jjhzgnma/
绝经期关节炎	jjqgjy/
绝经期尿路感染	jjqnlgr/
绝经期尿失禁	jjqnsj/
绝经期盆腔脏器脱垂	jjqpqzqtc/
绝经期乳腺癌	jjqrxa/
绝经与阿尔茨海默病综合征	jjyaechmbzhz/
绝经与心血管疾病	jjyxxgjb/
绝经与抑郁症	jjyyyz/
军刀综合征	jdzhz/
侵袭性指趾乳头状腺癌	qxxzzrtzxa/
神经棘红细胞增多症	sjjhxbzdz/
萎缩侧索硬化	wscsyh/
Kimura病	kimurab/
骶髂关节扭伤或半脱位	dqgjnshbtw/
卡普兰综合征	kplzhz/
卡氏肺孢子虫肺炎	ksfbzcfy/
卡氏肺囊虫病	ksfncb/
卡他莫拉菌感染	ktmljgr/
康诺尔立克次体斑疹热	knelkctbzr/
糠秕孢子菌毛囊炎	kbbzjmny/
抗活化的蛋白C症	khhddbcz/
抗菌药中毒性肾病	kjyzdxsb/
抗利尿激素分泌异常综合征	klnjsfmyczhz/
抗磷脂抗体综合征	klzktzhz/
抗体免疫缺陷病	ktmyqxb/
抗胰蛋白酶缺乏症	kydbmqfz/
考登病中的多发性毛鞘瘤	kdbzddfxmql/
柯莱斯骨折	klsgz/
柯萨奇病毒感染	ksqbdgr/
科干综合征	kgzhz/
科罗拉多蜱热	klldpr/
颗粒细胞瘤	klxbl/
咳嗽性哮喘	ksxxc/
咳嗽晕厥综合征	ksyjzhz/
克里格勒-纳贾尔综合征	klgl_njezhz/
克里米亚-刚果出血热	klmy_ggcxr/
克罗伊茨费尔特-雅各布病	klycfet_ygbb/
空鞍综合征	kazhz/
空肠、回肠憩室	kc_hcqs/
空肠弯曲菌肠炎	kcwqjcy/
空气栓塞	kqss/
口腔黏膜白斑	kqnmbb/
口形红细胞增多症	kxhxbzdz/
髋关节后脱位	kgjhtw/
眶骨髓炎	kgsy/
眶内纤维组织细胞瘤	knxwzzxbl/
溃疡病穿孔	kybck/
溃疡坏死性口炎	kyhsxky/
溃疡性皮肤结核	kyxpfjh/
扩张孔	kzk/
橄榄体脑桥小脑萎缩	gltnqxnws/
骨淋巴管瘤	glbgl/
拉福拉病	lflb/
拉沙热	lsr/
拉休尤-格拉哈姆-利特尔综合征	lxy_glhm_ltezhz/
蜡样芽孢杆菌食物中毒	lyybgjswzd/
莱姆心脏炎	lmxzy/
莱特雷尔-西韦病	ltle_xwb/
赖利-戴综合征	ll_dzhz/
赖氏综合征	lszhz_6083/
赖特综合征	ltzhz/
兰伯特-伊顿综合征	lbt_ydzhz/
阑尾腺癌	lwxa/
阑尾肿瘤	lwzl/
懒惰白细胞综合征	ldbxbzhz/
朗汉斯细胞的组织细胞增多症	lhsxbdzzxbzdz/
老年癌症病人的急性感染	lnazbrdjxgr/
老年斑	lnb_6091/
老年便秘	lnbm/
老年低温症	lndwz/
老年跌倒	lndd/
老年急性动脉栓塞	lnjxdmss/
老年静脉血栓症	lnjmxsz/
老年久病卧床	lnjbwc/
老年挛缩	lnls/
老年男性性功能障碍	lnnxxgnza/
老年女性膀胱颈梗阻	lnnxbgjgz/
老年期谵妄	lnqzw/
老年人白细胞减少症和粒细胞缺乏症	lnrbxbjszhlxbqfz/
老年人败血症	lnrbxz/
老年人膀胱癌	lnrbga/
老年人变异型心绞痛	lnrbyxxjt/
老年人病毒性肝炎	lnrbdxgy/
老年人病态窦房结综合征	lnrbtdfjzhz/
老年人播散性血管内凝血	lnrbsxxgnnx/
老年人不稳定型心绞痛	lnrbwdxxjt/
老年人肠易激综合征	lnrcyjzhz/
老年人垂体瘤	lnrctl/
老年人大肠肿瘤	lnrdczl/
老年人代谢性碱中毒	lnrdxxjzd/
老年人代谢性酸中毒	lnrdxxszd/
老年人单纯疱疹病毒性脑炎	lnrdcpzbdxny/
老年人胆囊癌	lnrdna/
老年人胆囊炎	lnrdny/
老年人胆石症	lnrdsz/
老年人低钙血症	lnrdgxz/
老年人低钾血症	lnrdjxz/
老年人低钠血症	lnrdnxz/
老年人低血糖昏迷	lnrdxthm/
老年人低血糖症	lnrdxtz/
老年人低血压	lnrdxy/
老年人短暂性大脑缺血性发作	lnrdzxdnqxxfz/
老年人多发性骨髓瘤	lnrdfxgsl/
老年人多器官功能衰竭	lnrdqggnsj/
老年人恶性心包积液	lnrexxbjy/
老年人非霍奇金恶性淋巴肿瘤	lnrfhqjexlbzl/
老年人肥厚型心肌病	lnrfhxxjb/
老年人肥胖症	lnrfpz/
老年人肺癌	lnrfa/
老年人肺结核	lnrfjh/
老年人肺结核病	lnrfjhb/
老年人肺脓肿	lnrfnz/
老年人肺气肿	lnrfqz/
老年人肺栓塞	lnrfss/
老年人肺心病	lnrfxb/
老年人肺性脑病	lnrfxnb/
老年人肺炎	lnrfy/
老年人分水岭脑梗死	lnrfslngs/
老年人风湿性心脏病	lnrfsxxzb/
老年人腹主动脉瘤	lnrfzdml/
老年人钙化性瓣膜病	lnrghxbmb/
老年人肝性脑病	lnrgxnb/
老年人肝硬化	lnrgyh/
老年人感染性休克	lnrgrxxk/
老年人高钙血症	lnrggxz/
老年人高钾血症	lnrgjxz/
老年人高钠血症	lnrgnxz/
老年人高渗性非酮症糖尿病昏迷	lnrgsxftztnbhm/
老年人高血压	lnrgxy/
老年人高血压危象	lnrgxywx/
老年人高脂血症	lnrgzxz/
老年人梗阻性肾病	lnrgzxsb/
老年人骨关节炎	lnrggjy/
老年人骨髓增生异常综合征	lnrgszsyczhz/
老年人骨质疏松	lnrgzss/
老年人过敏性紫癜	lnrgmxzd/
老年人呼吸衰竭	lnrhxsj/
老年人呼吸性酸中毒	lnrhxxszd/
老年人环咽肌功能障碍	lnrhyjgnza/
老年人霍奇金淋巴瘤	lnrhqjlbl/
老年人急腹症	lnrjfz/
老年人急进性肾炎	lnrjjxsy/
老年人急性非淋巴细胞白血病	lnrjxflbxbbxb/
老年人急性感染后肾炎	lnrjxgrhsy/
老年人急性呼吸窘迫综合征	lnrjxhxjpzhz/
老年人急性阑尾炎	lnrjxlwy/
老年人急性淋巴细胞白血病	lnrjxlbxbbxb/
老年人急性肾功能衰竭	lnrjxsgnsj/
老年人急性胰腺炎	lnrjxyxy/
老年人急性左心衰竭	lnrjxzxsj/
老年人脊髓压迫症	lnrjsypz/
老年人脊髓亚急性联合变性	lnrjsyjxlhbx/
老年人甲减性心脏病	lnrjjxxzb/
老年人甲亢性心脏病	lnrjkxxzb/
老年人甲状腺癌	lnrjzxa/
老年人甲状腺功能低下	lnrjzxgndx/
老年人甲状腺功能亢进危象	lnrjzxgnkjwx/
老年人甲状腺功能亢进症	lnrjzxgnkjz/
老年人假膜性小肠结肠炎	lnrjmxxcjcy/
老年人间质性肺炎	lnrjzxfy/
老年人结肠憩室	lnrjcqs/
老年人结肠息肉	lnrjcxr/
老年人结核性脑膜炎	lnrjhxnmy/
老年人结节病	lnrjjb/
老年人颈性眩晕	lnrjxxy/
老年人酒精性肝病	lnrjjxgb/
老年人酒精性心脏病	lnrjjxxzb_6190/
老年人巨幼细胞性贫血	lnrjyxbxpx/
老年人扩张型心肌病	lnrkzxxjb/
老年人类风湿性关节炎	lnrlfsxgjy/
老年人流行性感冒	lnrlxxgm/
老年人颅内压增高	lnrlnyzg/
老年人慢性疾病性贫血	lnrmxjbxpx/
老年人慢性粒细胞白血病	lnrmxlxbbxb/
老年人慢性淋巴细胞白血病	lnrmxlbxbbxb/
老年人慢性肾功能衰竭	lnrmxsgnsj/
老年人慢性肾盂肾炎	lnrmxsysy/
老年人慢性胃炎	lnrmxwy/
老年人慢性支气管炎	lnrmxzqgy/
老年人梅毒性心脏病	lnrmdxxzb/
老年人泌尿系结石	lnrmnxjs/
老年人泌尿系统感染	lnrmnxtgr/
老年人免疫性血小板减少性紫癜	lnrmyxxxbjsxzd/
老年人脑出血	lnrncx/
老年人脑栓塞	lnrnss/
老年人脑心综合征	lnrnxzhz/
老年人脑血栓形成	lnrnxsxc/
老年人黏液性瓣膜病	lnrnyxbmb/
老年人尿崩症	lnrnbz/
老年人尿毒症性肺炎	lnrndzxfy/
老年人尿失禁	lnrnsj/
老年人帕金森病	lnrpjsb/
老年人期前收缩	lnrqqss/
老年人前列腺癌	lnrqlxa/
老年人前列腺增生症	lnrqlxzsz/
老年人腔隙性脑梗死	lnrqxxngs/
老年人缺铁性贫血	lnrqtxpx/
老年人缺血性结肠炎	lnrqxxjcy/
老年人缺血性心肌病	lnrqxxxjb/
老年人溶血性贫血	lnrrxxpx/
老年人乳头肌功能不全和断裂	lnrrtjgnbqhdl/
老年人乳腺癌	lnrrxa/
老年人上腔静脉受压综合征	lnrsqjmsyzhz/
老年人上消化道出血	lnrsxhdcx/
老年人神经梅毒	lnrsjmd/
老年人神经症	lnrsjz/
老年人肾癌	lnrsa/
老年人肾病综合征	lnrsbzhz/
老年人食管癌	lnrsga/
老年人食管裂孔疝	lnrsglks/
老年人室性期前收缩	lnrsxqqss/
老年人室性心动过速	lnrsxxdgs/
老年人嗜铬细胞瘤危象	lnrsgxblwx/
老年人睡眠呼吸暂停综合征	lnrsmhxztzhz/
老年人睡眠障碍	lnrsmza/
老年人糖尿病	lnrtnb/
老年人糖尿病乳酸性中毒	lnrtnbrsxzd/
老年人糖尿病肾病	lnrtnbsb/
老年人糖尿病酮症酸中毒	lnrtnbtzszd/
老年人糖尿病性心脏病	lnrtnbxxzb/
老年人糖尿病周围神经病	lnrtnbzwsjb/
老年人特发性肺纤维化	lnrtfxfxwh/
老年人痛风	lnrtf/
老年人脱水	lnrts/
老年人胃癌	lnrwa/
老年人胃食管反流病	lnrwsgflb/
老年人稳定型心绞痛	lnrwdxxjt/
老年人无症状性心肌缺血	lnrwzzxxjqx/
老年人吸入性肺炎	lnrxrxfy/
老年人细菌性脑膜炎	lnrxjxnmy/
老年人夏伊-德雷格综合征	lnrxy_dlgzhz/
老年人先天性心血管疾病	lnrxtxxxgjb/
老年人消化性溃疡	lnrxhxky/
老年人心房扑动	lnrxfpd/
老年人心房纤颤	lnrxfxc/
老年人心肌梗死	lnrxjgs/
老年人心力衰竭	lnrxlsj/
老年人心内膜炎	lnrxnmy/
老年人心脑综合征	lnrxnzhz/
老年人心室扑动与颤动	lnrxspdycd/
老年人心源性休克	lnrxyxxk/
老年人心脏传导阻滞	lnrxzcdzz/
老年人心脏猝死	lnrxzcs/
老年人心脏淀粉样变性	lnrxzdfybx/
老年人胸腔积液与胸膜炎	lnrxqjyyxmy/
老年人血管性痴呆	lnrxgxcd/
老年人血栓性疾病	lnrxsxjb/
老年人炎症性肠病	lnryzxcb/
老年人厌氧菌性肺炎	lnryyjxfy/
老年人阳性杆菌肺炎	lnryxgjfy/
老年人药物性肝病	lnrywxgb/
老年人胰腺癌	lnryxa/
老年人异位抗利尿素分泌综合征	lnrywklnsfmzhz/
老年人预激综合征	lnryjzhz/
老年人原发性肝癌	lnryfxga/
老年人原发性高血压引起的良性小动脉肾硬化	lnryfxgxyyqdlxxdmsyh/
老年人原发性骨髓纤维化	lnryfxgsxwh/
老年人原发性血小板增多症	lnryfxxxbzdz/
老年人院内获得性肺炎	lnrynhdxfy/
老年人运动神经元病	lnrydsjyb/
老年人再生障碍性贫血	lnrzszaxpx/
老年人真性红细胞增多症	lnrzxhxbzdz/
老年人阵发性室上性心动过速	lnrzfxssxxdgs/
老年人正常压力脑积水	lnrzcylnjs/
老年人支气管扩张	lnrzqgkz/
老年人支气管哮喘	lnrzqgxc/
老年人支原体肺炎	lnrzytfy/
老年人脂肪肝	lnrzfg/
老年人终末期肺炎	lnrzmqfy/
老年人重症肌无力	lnrzzjwl/
老年人蛛网膜下腔出血	lnrzwmxqcx/
老年人主动脉夹层分离	lnrzdmjcfl/
老年人主动脉瘤	lnrzdml/
老年人椎基底动脉供血不足	lnrzjddmgxbz/
老年人自发性气胸	lnrzfxqx/
老年褥疮	lnrc/
老年收缩期高血压	lnssqgxy/
老年心肌病	lnxjb/
老年性癫痫	lnxdx/
老年性慢性硬膜下血肿	lnxmxymxxz/
老年性皮肤萎缩	lnxpfws/
老年性外阴萎缩	lnxwyws/
老年性舞蹈病	lnxwdb/
老年性心瓣膜病	lnxxbmb/
老年休克	lnxk/
老视	ls/
勒夫勒心内膜炎	lflxnmy/
雷凡斯坦综合征	lfstzhz/
泪囊肿瘤	lnzl/
泪腺多形性腺癌	lxdxxxa/
泪腺多形性腺瘤	lxdxxxl/
泪腺炎	lxy/
类丹毒	ldd/
类肺炎性胸腔积液	lfyxxqjy/
类固醇后脂膜炎	lgchzmy/
类固醇肌病	lgcjb/
类圆线虫病	lyxcb/
类脂性肺炎	lzxfy/
类脂质蛋白沉积症	lzzdbcjz/
冷抗体型自身免疫性溶血性贫血	lktxzsmyxrxxpx/
冷凝集素综合征	lnjszhz/
冷球蛋白血症	lqdbxz/
冷球蛋白血症肾损害	lqdbxzssh/
梨状肌症候群	lzjzhq/
理发师皮炎	lfspy/
锂肾病	lsb/
立氏立克次体斑疹热	lslkctbzr/
利德尔综合征	ldezhz/
镰刀菌病	ldjb/
镰状细胞贫血眼部病变	lzxbpxybbb/
镰状细胞性肾病	lzxbxsb/
良性淋巴细胞血管炎和肉芽肿病	lxlbxbxgyhryzb/
良性颅内高压症	lxlngyz/
裂沟舌	lgs/
裂谷热	lgr/
裂头绦虫病	lttcb/
裂头蚴病	ltyb/
淋巴瘤样丘疹病	lblyqzb/
淋巴瘤样肉芽肿	lblyryz/
淋巴瘤引起的肾损害	lblyqdssh/
淋巴细胞性脉络丛脑膜炎	lbxbxmlcnmy/
淋球菌性腹膜炎	lqjxfmy/
淋球菌性结膜炎	lqjxjmy/
磷脂酰胆碱-胆固醇酰基转移酶缺乏	lzxdj_dgcxjzymqf/
流感嗜血杆菌肺炎	lgsxgjfy/
流感嗜血杆菌感染	lgsxgjgr/
流感嗜血杆菌脑膜炎	lgsxgjnmy/
龙线虫病	lxcb/
隆突性皮肤纤维肉瘤	ltxpfxwrl/
颅骨骨膜窦	lggmd/
颅骨结核	lgjh/
颅骨巨细胞瘤	lgjxbl/
颅骨裂和有关畸形	lglhygjx/
颅后窝室管膜瘤	lhwsgml/
颅后窝血肿	lhwxz/
颅内海绵状血管瘤	lnhmzxgl/
颅内黑色素瘤	lnhssl/
颅内畸胎瘤	lnjtl/
颅内脊索瘤	lnjsl/
颅内静脉窦闭塞性颅高压	lnjmdbsxlgy/
颅内静脉血栓形成	lnjmxsxc/
颅内生殖细胞瘤	lnszxbl/
颅内肿瘤	lnzl_6366/
颅内肿瘤伴发的精神障碍	lnzlbfdjsza/
颅内肿瘤性出血	lnzlxcx/
铝尘肺	lcf/
铝骨病	lgb/
绿猴病	lhb/
卵巢成熟畸胎瘤	lccsjtl/
卵巢恶性腹膜间皮瘤	lcexfmjpl/
卵巢恶性中胚叶混合瘤	lcexzpyhhl/
卵巢功能缺如综合征	lcgnqrzhz/
卵巢功能异常综合征	lcgnyczhz/
卵巢宫内膜样肿瘤	lcgnmyzl/
卵巢冠囊肿	lcgnz/
卵巢过度刺激综合征	lcgdcjzhz/
卵巢环管状性索肿瘤	lchgzxszl/
卵巢黄体囊肿破裂	lchtnzpl/
卵巢混合性生殖细胞-性索间质肿瘤	lchhxszxb_xsjzzl/
卵巢肌肉来源肿瘤	lcjrlyzl/
卵巢浆液性肿瘤	lcjyxzl/
卵巢交界性肿瘤	lcjjxzl/
卵巢颗粒细胞瘤	lcklxbl/
卵巢两性母细胞瘤	lclxmxbl/
卵巢卵黄囊瘤	lclhnl/
卵巢泡膜细胞瘤	lcpmxbl/
卵巢妊娠	lcrs/
卵巢透明细胞肿瘤	lctmxbzl/
卵巢未成熟畸胎瘤	lcwcsjtl/
卵巢无性细胞瘤	lcwxxbl/
卵巢纤维瘤	lcxwl/
卵巢纤维瘤病	lcxwlb/
卵巢纤维组织来源肿瘤	lcxwzzlyzl/
卵巢小细胞癌	lcxxba/
卵巢硬化性间质瘤	lcyhxjzl/
卵巢肿瘤	lczl/
卵巢肿瘤破裂	lczlpl/
卵巢重度水肿	lczdsz/
卵黄状黄斑营养不良	lhzhbyybl/
卵泡囊肿	lpnz/
卵泡腺细胞增殖综合征	lpxxbzzzhz/
螺菌病	ljb/
瘰疬分枝杆菌感染	llfzgjgr/
瘰疬性皮肤结核病	llxpfjhb/
瘰疬性苔藓	llxtx/
洛博芽生菌病	lbysjb/
疟疾肾病	njsb/
诺卡菌性巩膜炎	nkjxgmy/
巯甲丙脯酸肾损害	qjbfsssh/
乳房单纯囊肿	rfdcnz/
乳头溢液	rtyy/
乳腺导管扩张症	rxdgkzz/
乳腺囊性增生病	rxnxzsb/
乳腺腺病	rxxb/
中枢神经系统淋巴瘤	zssjxtlbl/
Machado-Joseph病	machado_josephb/
Morton跖头痛	mortonztt/
麻痹性痴呆	mbxcd/
麻风性葡萄膜炎	mfxptmy/
麻风性周围神经病	mfxzwsjb/
麻疹样红斑	mzyhb/
马尔尼菲青霉病	menfqmb/
马方综合征	mfzhz/
马拉色菌病	mlsjb/
脉络丛乳头状瘤	mlcrtzl/
脉络膜出血	mlmcx/
脉络膜骨瘤	mlmgl/
脉络膜脱离	mlmtl/
脉络膜脱离型视网膜脱离	mlmtlxswmtl/
脉络膜新生血管	mlmxsxg/
脉络膜血管瘤	mlmxgl/
螨皮炎	mpy/
慢性创伤性滑囊炎	mxcsxhny/
慢性颈部软组织损伤	mxjbrzzss/
慢性酒中毒	mxjzd/
慢性卡他性结膜炎	mxktxjmy/
慢性溃疡性非肉芽肿性空肠回肠炎	mxkyxfryzxkchcy/
慢性劳损性腰背痛	mxlsxybt/
慢性盆腔炎	mxpqy/
慢性肾性贫血	mxsxpx/
慢性腰部劳损	mxybls/
慢性自身免疫性甲状腺炎	mxzsmyxjzxy/
慢性纵隔炎	mxzgy/
慢性阻塞性肺疾病	mxzsxfjb/
盲肠扭转	mcnz/
盲肠旁疝	mcps/
猫抓病	mzb/
毛孢子菌病	mbzjb/
毛滴虫病	mdcb/
毛根鞘癌	mgqa/
毛霉病	mmb/
毛母质瘤	mmzl/
毛囊角化病	mnjhb/
毛囊瘤	mnl/
毛囊漏斗肿瘤	mnldzl/
毛囊脓疱病	mnnpb/
毛囊皮脂腺囊性错构瘤	mnpzxnxcgl/
毛囊性黏蛋白病	mnxndbb/
毛囊性鱼鳞病	mnxylb/
毛囊周围纤维瘤	mnzwxwl/
毛盘瘤	mpl/
毛胚细胞瘤	mpxbl/
毛鞘棘皮瘤	mqjpl/
毛细淋巴管瘤	mxlbgl/
毛细血管或静脉血栓形成	mxxghjmxsxc/
毛细血管扩张性共济失调综合征	mxxgkzxgjsdzhz/
毛细血管扩张性环状紫癜	mxxgkzxhzzd/
毛圆线虫病	myxcb/
毛状白斑	mzbb/
梅毒性巩膜炎	mdxgmy/
梅毒性骨软骨炎	mdxgrgy/
梅毒性关节炎	mdxgjy/
梅毒性角膜病变	mdxjmbb/
梅毒性葡萄膜炎	mdxptmy/
梅克尔细胞癌	mkexba/
梅勒尼坏疽	mlnhj/
梅尼埃病	mnab/
湄公血吸虫病	mgxxcb/
门静脉高压性胃病	mjmgyxwb/
门静脉血栓形成	mjmxsxc/
门脉高压性肠病	mmgyxcb/
弥漫性空回肠溃疡	mmxkhcky/
弥漫性食管壁内憩室	mmxsgbnqs/
弥漫性掌跖角化病	mmxzzjhb/
米氏链球菌肺炎	mslqjfy/
泌尿道肿瘤	mndzl/
泌尿道肿瘤皮肤转移	mndzlpfzy/
泌尿生殖系阿米巴病	mnszxambb/
泌尿生殖系滴虫病	mnszxdcb/
泌尿生殖系放线菌病	mnszxfxjb/
泌尿生殖系棘球蚴病	mnszxjqyb/
泌尿生殖系血吸虫病	mnszxxxcb/
泌尿生殖系真菌病	mnszxzjb/
泌尿生殖系支原体感染	mnszxzytgr/
棉尘肺	mcf/
面部播散性粟粒状狼疮	mbbsxslzlc/
面部脓皮病	mbnpb/
面部偏侧萎缩	mbpcws/
面部肉芽肿	mbryz/
面肌抽搐	mjcc/
面颈部毛囊性红斑黑变病	mjbmnxhbhbb/
面瘫唇肿裂纹舌综合征	mtczlwszhz/
摩擦黑变病	mchbb/
摩擦性苔藓样疹	mcxtxyz/
摩根菌肺炎	mgjfy/
木村网状肢端色素沉着	mcwzzdsscz/
赖特综合征性巩膜炎	ltzhzxgmy/
内分泌性肌病	nfmxjb/
内脏利什曼病	nzlsmb/
内脏血吸虫炎	nzxxcy/
男假两性畸形	njlxjx/
男性青春期乳房发育	nxqcqrffy/
男性性早熟	nxxzs/
男子雄激素源性秃发	nzxjsyxtf/
难治性心力衰竭	nzxxlsj/
脑干损伤	ngss/
脑干肿瘤	ngzl/
脑回状颅皮	nhzlp/
脑膜炎球菌性脑膜炎	nmyqjxnmy/
脑膜炎球菌血症	nmyqjxz/
脑膨出和脑脊膜膨出	npchnjmpc/
脑桥中央髓鞘溶解症	nqzysqrjz/
脑缺血性疾病	nqxxjb/
脑外伤后综合征	nwshzhz/
脑型疟疾	nxnj/
脑型血吸虫病	nxxxcb/
尼曼-皮克病	nm_pkb/
泥螺-日光性皮炎	nl_rgxpy/
黏多糖贮积症	ndtzjz/
黏多糖贮积症Ⅰ型	ndtzjz_x/
黏多糖贮积症Ⅱ型	ndtzjz_x_6534/
黏多糖贮积症Ⅲ型	ndtzjz_x_6535/
黏多糖贮积症Ⅳ型	ndtzjz_x_6536/
黏多糖贮积症Ⅴ型	ndtzjz_x_6537/
黏多糖贮积症Ⅵ型	ndtzjz_x_6538/
黏多糖贮积症Ⅶ型	ndtzjz_x_6539/
黏多糖贮积症Ⅷ型	ndtzjz_x_6540/
黏膜白斑	nmbb/
黏膜白色海绵状痣	nmbshmzz/
黏膜相关样组织淋巴瘤	nmxgyzzlbl/
黏液纤维肉瘤	nyxwrl/
黏液性小汗腺癌	nyxxhxa/
黏脂贮积症Ⅰ型	nzzjz_x/
黏脂贮积症Ⅱ型	nzzjz_x_6547/
黏脂贮积症Ⅲ型	nzzjz_x_6548/
黏脂贮积症Ⅳ型	nzzjz_x_6549/
念珠菌病	nzjb/
念珠状发	nzzf/
念珠状红苔藓	nzzhtx/
鸟枪弹样视网膜脉络膜病变	nqdyswmmlmbb/
尿道旁腺癌	ndpxa/
尿道憩室	ndqs/
尿道缺如及先天性尿道闭锁	ndqrjxtxndbs/
尿道肉阜	ndrf/
尿毒症性心包炎	ndzxxby/
尿毒症性心肌病	ndzxxjb/
尿黑酸尿与褐黄病	nhsnyhhb/
镍皮炎	npy/
牛痘	nd/
牛痘样水疱病	ndyspb/
农民肺	nmf/
农药中毒性肾病	nyzdxsb/
脓毒症和菌血症	ndzhjxz/
脓疱病	npb/
女性的青春期延迟	nxdqcqyc/
女性生殖道多部位原发癌	nxszddbwyfa/
女性性早熟	nxxzs_6570/
Poncet综合征	poncetzhz/
PUVA雀斑样痣	puvaqbyz/
膀胱不发育与发育不全	bgbfyyfybq/
膀胱结核	bgjh/
膀胱平滑肌瘤	bgphjl/
膀胱平滑肌肉瘤	bgphjrl/
膀胱葡萄状肉瘤	bgptzrl/
膀胱憩室	bgqs/
膀胱上内疝	bgsns/
膀胱嗜铬细胞瘤	bgsgxbl/
膀胱输尿管反流	bgsngfl/
膀胱与尿道结石	bgyndjs/
膀胱肿瘤	bgzl/
贲门黏膜撕裂综合征	bmnmslzhz/
脯肽酶缺乏症	ftmqfz/
盘尾丝虫病	pwscb/
疱疹样皮炎	pzypy/
盆底腹膜疝	pdfms/
盆腔脓肿	pqnz/
皮肤B细胞淋巴样结节型增生	pfbxblbyjjxzs/
皮肤T细胞淋巴样增生	pftxblbyzs/
皮肤阿米巴病	pfambb/
皮肤白细胞破碎性血管炎	pfbxbpsxxgy/
皮肤白血病	pfbxb/
皮肤卟啉病	pfblb/
皮肤穿入性毛囊和毛囊周角化病	pfcrxmnhmnzjhb/
皮肤恶性黑色素瘤	pfexhssl/
皮肤发育不良	pffybl/
皮肤弓形体病	pfgxtb/
皮肤骨瘤	pfgl/
皮肤骨髓纤维化	pfgsxwh/
皮肤利什曼病	pflsmb/
皮肤淋巴肉芽肿病	pflbryzb/
皮肤淋巴细胞浸润症	pflbxbjrz/
皮肤淋巴细胞瘤	pflbxbl/
皮肤黏膜淋巴结综合征	pfnmlbjzhz/
皮肤黏液瘤	pfnyl/
皮肤软骨瘤	pfrgl/
皮肤瘙痒症	pfsyz/
皮肤神经瘤	pfsjl/
皮肤丝虫病	pfscb/
皮肤松垂	pfsc/
皮肤炭疽	pftj/
皮肤纤毛囊肿	pfxmnz/
皮肤纤维瘤	pfxwl/
皮肤腺样囊性癌	pfxynxa/
皮肤行为症	pfxwz/
皮肤癣菌病	pfxjb/
皮肤蝇蛆病	pfyqb/
皮肤幼虫移行症	pfycyxz/
皮肤猪囊尾蚴病	pfznwyb/
皮肤子宫内膜异位症	pfzgnmywz/
皮角	pj/
皮克病	pkb/
皮克病性痴呆	pkbxcd/
皮下T细胞淋巴瘤	pxtxblbl/
皮下脂肪肉芽肿	pxzfryz/
皮下脂膜炎性T细胞淋巴瘤	pxzmyxtxblbl/
皮样表皮样囊肿	pybpynz/
皮脂缺乏症	pzqfz/
皮脂腺癌	pzxa/
皮脂腺腺瘤	pzxxl/
皮脂腺增生	pzxzs/
脾动脉瘤	pdml/
脾囊肿	pnz/
脾脓肿	pnz_6636/
脾脏转移性肿瘤	pzzyxzl/
片吸虫病	pxcb/
胼胝	pz/
胼胝体进行性变性	pztjxxbx/
品他病	ptb/
品行障碍	pxza/
平底足	pdz/
平滑肌肉瘤	phjrl/
蹼状阴茎	pzyj/
先天性膀胱颈挛缩	xtxbgjls/
寇热	kr/
槭糖尿病	qtnb/
漆所致皮肤病	qszpfb/
其他病毒肺炎	qtbdfy/
其他弧菌感染	qthjgr/
其他晶体性关节病	qtjtxgjb/
其他类精神活性物质依赖	qtljshxwzyl/
其他沙门菌感染	qtsmjgr/
奇孔古尼亚病毒性疾病	qkgnybdxjb/
脐部脐肠系膜管息肉	qbqcxmgxr/
脐尿管囊肿	qngnz/
脐疝	qs/
脐炎	qy/
起搏器综合征	qbqzhz/
气单胞菌肺炎	qdbjfy/
气管梗阻	qggz_6662/
气管前间隙感染	qgqjxgr/
气管食管瘘	qgsgl/
气性膀胱炎	qxbgy/
髂骨取骨后盆侧腹壁疝	qgqghpcfbs/
髂骨致密性骨炎	qgzmxgy/
千足虫灼伤	qzczs/
前臂动脉损伤	qbdmss/
前骨间神经卡压综合征	qgjsjkyzhz/
前列腺囊肿	qlxnz/
前列腺脓肿	qlxnz_6672/
前列腺肉瘤	qlxrl/
前十字韧带损伤	qszrdss/
前庭大腺癌	qtdxa/
前庭大腺囊肿	qtdxnz/
前纵韧带骨化症	qzrdghz/
钱币状湿疹	qbzsz/
钱币状掌跖角化病	qbzzzjhb/
浅部急性淋巴结炎和淋巴管炎	qbjxlbjyhlbgy/
嵌顿性腹股沟斜疝	qdxfggxs/
腔隙性脑梗死	qxxngs/
强直性脊柱炎性巩膜炎	qzxjzyxgmy/
侵袭性婴儿纤维瘤病	qxxyexwlb/
青春期发育迟缓	qcqfych/
青春期功能失调性子宫出血	qcqgnsdxzgcx/
青春期功能失调性子宫出血病	qcqgnsdxzgcxb/
青年人中的成年发病型糖尿病	qnrzdcnfbxtnb/
青年上肢远端肌萎缩	qnszydjws/
青年心肌梗死	qnxjgs/
青年性驼背	qnxtb/
青少年及小儿卵巢肿瘤	qsnjxelczl/
青少年及小儿阴道肉瘤	qsnjxeydrl/
青少年及小儿阴道透明细胞癌	qsnjxeydtmxba/
青少年及小儿子宫颈癌	qsnjxezgja/
丘疹性荨麻疹	qzxqmz/
丘疹性血管增生	qzxxgzs/
丘疹紫癜性手套和短袜样综合征	qzzdxsthdwyzhz/
曲霉病	qmb_6699/
曲霉球	qmq/
躯体感染伴发的精神障碍	qtgrbfdjsza/
全身性发疹性组织细胞增生症	qsxfzxzzxbzsz/
全身脂肪代谢障碍	qszfdxza/
缺血性多形性室性心动过速	qxxdxxsxxdgs/
Reis-Bucklers角膜营养不良	reis_bucklersjmyybl/
Rh血型不合溶血病	rhxxbhrxb/
诺卡菌病	nkjb/
染色体异常	rstyc/
染色体异常伴发的精神障碍	rstycbfdjsza/
桡骨茎突骨折	rgjtgz/
桡骨头骨折	rgtgz/
桡管综合征	rgzhz/
桡神经感觉支卡压	rsjgjzky/
热带性出汗不良	rdxchbl/
热带性口炎性腹泻	rdxkyxfx/
人格解体-现实解体综合征	rgjt_xsjtzhz/
人类T淋巴细胞病毒感染	rltlbxbbdgr/
人类免疫缺陷病毒所致葡萄膜炎	rlmyqxbdszptmy/
人免疫缺陷病毒感染性肾损害	rmyqxbdgrxssh/
人疱疹病毒-6型感染	rpzbd_6xgr/
人为性皮炎	rwxpy/
人为脂膜炎	rwzmy/
妊娠高血压综合征	rsgxyzhz/
妊娠高血压综合征眼底病变	rsgxyzhzydbb/
妊娠合并白血病	rshbbxb/
妊娠合并癫痫	rshbdx/
妊娠合并动脉导管未闭	rshbdmdgwb/
妊娠合并多囊肾	rshbdns/
妊娠合并肺炎	rshbfy/
妊娠合并风湿性心脏病	rshbfsxxzb/
妊娠合并肝硬化	rshbgyh/
妊娠合并红细胞增多症	rshbhxbzdz/
妊娠合并急性膀胱炎	rshbjxbgy/
妊娠合并急性胆囊炎	rshbjxdny/
妊娠合并急性阑尾炎	rshbjxlwy/
妊娠合并急性肾小球肾炎	rshbjxsxqsy/
妊娠合并急性肾盂肾炎	rshbjxsysy/
妊娠合并急性胰腺炎	rshbjxyxy/
妊娠合并甲状旁腺功能亢进	rshbjzpxgnkj/
妊娠合并甲状腺功能减退	rshbjzxgnjt/
妊娠合并甲状腺功能亢进	rshbjzxgnkj/
妊娠合并巨幼红细胞性贫血	rshbjyhxbxpx/
妊娠合并类风湿关节炎	rshblfsgjy/
妊娠合并淋巴瘤	rshblbl/
妊娠合并卵巢肿瘤	rshblczl/
妊娠合并慢性肾上腺皮质功能减退	rshbmxssxpzgnjt/
妊娠合并慢性肾小球肾炎	rshbmxsxqsy/
妊娠合并尿石症	rshbnsz/
妊娠合并皮质醇增多症	rshbpzczdz/
妊娠合并偏头痛	rshbptt/
妊娠合并缺铁性贫血	rshbqtxpx/
妊娠合并肾病综合征	rshbsbzhz/
妊娠合并系统性红斑狼疮	rshbxtxhblc/
妊娠合并消化性溃疡	rshbxhxky/
妊娠合并哮喘	rshbxc/
妊娠合并心房间隔缺损	rshbxfjgqs/
妊娠合并心室间隔缺损	rshbxsjgqs/
妊娠合并血栓性疾病	rshbxsxjb/
妊娠合并血栓性血小板减少性紫癜	rshbxsxxxbjsxzd/
妊娠合并硬皮病	rshbypb/
妊娠合并原发性高血压	rshbyfxgxy/
妊娠合并再生障碍性贫血	rshbzszaxpx/
妊娠合并重症肌无力	rshbzzjwl/
妊娠合并子宫肌瘤	rshbzgjl/
妊娠合并自身免疫性溶血性贫血	rshbzsmyxrxxpx/
妊娠呕吐	rsot/
妊娠疱疹	rspz/
妊娠期肝内胆汁淤积症	rsqgndzyjz/
妊娠期肝血肿及破裂	rsqgxzjpl/
妊娠期急性肾功能衰竭	rsqjxsgnsj/
妊娠期急性脂肪肝	rsqjxzfg/
妊娠期甲状腺功能亢进	rsqjzxgnkj/
妊娠期糖尿病	rsqtnb/
妊娠舞蹈病	rswdb/
妊娠性急性阑尾炎	rsxjxlwy/
妊娠性哮喘	rsxxc/
妊娠性心肌梗死	rsxxjgs/
妊娠痒疹	rsyz/
日本血吸虫病	rbxxcb/
日光皮炎	rgpy/
日光性雀斑样痣	rgxqbyz/
肉孢子虫病	rbzcb/
肉瘤皮肤转移	rlpfzy/
肉芽肿性唇炎	ryzxcy/
肉芽肿性前列腺炎	ryzxqlxy/
肉芽肿性松弛皮肤	ryzxscpf/
蠕形螨病	rxmb/
乳房导管内乳头状瘤	rfdgnrtzl/
乳房棘球蚴病	rfjqyb/
乳房结核	rfjh/
乳房缺少症	rfqsz/
乳房神经纤维瘤	rfsjxwl/
乳房湿疹	rfsz/
乳房丝虫病	rfscb/
乳房外湿疹样癌	rfwszya/
乳糜尿	rmn/
乳糜泻	rmx/
乳糜胸	rmx_6798/
多形红斑样皮疹	dxhbypz/
乳头内陷	rtnx/
乳头侵蚀性腺瘤病	rtqsxxlb/
乳头炎和乳晕炎	rtyhryy/
乳头状汗腺腺瘤	rtzhxxl/
乳腺癌皮肤转移	rxapfzy/
乳腺癌肉瘤	rxarl/
乳腺错构瘤	rxcgl/
乳腺纤维肉瘤	rxxwrl/
乳腺纤维腺瘤	rxxwxl/
乳腺叶状囊肉瘤	rxyznrl/
乳溢症	ryz/
软骨样汗管瘤	rgyhgl/
软组织肉瘤	rzzrl/
瑞列绦虫病	rltcb/
失认症	srz/
SARS的胃肠道感染	sarsdwcdgr/
唇舌水肿及面瘫综合征	csszjmtzhz/
塞泽里综合征	szlzhz/
腮腺恶性肿瘤	sxexzl/
散光	sg/
桑毛虫皮炎	smcpy/
色素性化妆品皮炎	ssxhzppy/
色素性静脉旁视网膜脉络膜萎缩	ssxjmpswmmlmws/
色素性口周红斑	ssxkzhb/
色素性紫癜性苔藓样皮病	ssxzdxtxypb/
色素性紫癜性苔藓样皮炎	ssxzdxtxypy/
上干型胸廓出口综合征	sgxxkckzhz/
上巩膜静脉压升高所致青光眼	sgmjmysgszqgy/
上气道梗阻	sqdgz/
上腔静脉综合征	sqjmzhz/
砷及其化合物引起的皮肤病	sjqhhwyqdpfb/
神经病性关节病	sjbxgjb/
神经官能性表皮剥脱	sjgnxbpbt/
神经内分泌肿瘤	sjnfmzl/
神经内分泌肿瘤皮肤转移	sjnfmzlpfzy/
神经鞘源性肿瘤	sjqyxzl/
神经系统结节病	sjxtjjb/
神经系统先天性疾病	sjxtxtxjb/
神经系统遗传病	sjxtycb/
神经元蜡样脂褐质沉积症	sjylyzhzcjz/
肾淀粉样变性	sdfybx/
肾动静脉瘘	sdjml/
肾动脉栓塞	sdmss/
肾动脉狭窄	sdmxz/
肾动脉血栓形成和栓塞	sdmxsxchss/
肾积脓	sjn/
肾母细胞瘤	smxbl/
肾上腺皮质功能减退性心脏病	ssxpzgnjtxxzb/
肾上腺皮质功能异常伴发的精神障碍	ssxpzgnycbfdjsza/
肾上腺素能依赖性尖端扭转性室性心动过速	ssxsnylxjdnzxsxxdgs/
肾嗜酸细胞瘤	sssxbl/
肾髓质坏死	sszhs/
肾髓质囊性病	ssznxb/
肾性尿崩症	sxnbz/
肾性失镁	sxsm/
肾性糖尿	sxtn/
肾旋转异常	sxzyc/
肾血管畸形与压迫	sxgjxyyp/
肾盂肿瘤	syzl/
渗出性多形红斑	scxdxhb/
渗出性盘状苔藓样皮炎	scxpztxypy/
生长激素缺乏症	scjsqfz/
生脓性肉芽肿	snxryz/
生乳头汗管囊腺瘤	srthgnxl/
生殖道肿瘤	szdzl/
生殖道肿瘤皮肤转移	szdzlpfzy/
失眠	sm_6866/
失用症	syz_6867/
虱病	sb_6868/
十二指肠静脉曲张	sezcjmqz/
十二指肠溃疡	sezcky/
十二指肠类癌	sezcla/
十二指肠良性肿瘤	sezclxzl/
十二指肠内瘘	sezcnl/
十二指肠旁疝	sezcps/
十二指肠平滑肌肉瘤	sezcphjrl/
十二指肠胃反流及胆汁反流性胃炎	sezcwfljdzflxwy/
十二指肠腺癌	sezcxa/
石棉业所致的皮肤病	smyszdpfb/
石棉状糠疹	smzkz/
实体肿瘤的肾损害	stzldssh/
实体肿瘤的肾脏损害	stzldszsh/
食管白斑	sgbb/
食管穿孔	sgck/
食管穿透性损伤	sgctxss/
食管腐蚀性灼伤	sgfsxzs/
食管管型	sggx/
食管过短	sggd/
食管化学性烧伤	sghxxss/
食管结核	sgjh/
食管克罗恩病	sgkleb/
食管类癌	sgla/
食管内异物	sgnyw/
食管囊肿	sgnz/
食管黏膜损伤	sgnmss/
食管念珠菌感染	sgnzjgr/
食管其他恶性肿瘤	sgqtexzl/
食管乳头状瘤	sgrtzl/
食管胃底静脉曲张及其破裂出血	sgwdjmqzjqplcx/
食管息肉	sgxr/
食管血管瘤	sgxgl/
食管压迫型颈椎病	sgypxjzb/
食管异位组织	sgywzz/
食管中段憩室	sgzdqs/
食管重复畸形	sgzfjx/
史-约综合征	s_yzhz/
矢状窦旁脑膜瘤	szdpnml/
视神经胶质瘤	ssjjzl/
视神经乳头水肿及视盘水肿	ssjrtszjspsz/
视网膜下新生血管膜	swmxxsxgm/
视网膜血管炎	swmxgy/
室间隔膜部瘤	sjgmbl/
室性并行心律及室性并行心律性心动过速	sxbxxljsxbxxlxxdgs/
室性期前收缩	sxqqss/
室性逸搏及室性逸搏心律	sxybjsxybxl/
适应障碍	syza/
嗜碱性粒细胞增多症	sjxlxbzdz/
嗜麦芽黄单胞菌肺炎	smyhdbjfy/
嗜皮菌病	spjb/
嗜人T淋巴细胞Ⅰ型所致的葡萄膜炎	srtlbxb_xszdptmy/
嗜水气单胞菌感染	ssqdbjgr/
嗜酸性粒细胞性膀胱炎	ssxlxbxbgy/
嗜酸性粒细胞增多-肌痛综合征	ssxlxbzd_jtzhz/
嗜酸性脓疱性毛囊炎	ssxnpxmny/
手部伸肌腱损伤	sbsjjss/
手部神经损伤	sbsjss/
手部血管损伤	sbxgss/
手湿疹	ssz_6927/
手术后反流性胃炎	sshflxwy/
手术后膈疝	sshgs/
手足发绀症	szfgz/
枢椎齿突骨折	szctgz/
舒尔曼病	semb/
舒张性心力衰竭	szxxlsj/
输卵管癌三联症	slgaslz/
输卵管结核	slgjh/
输尿管结核	sngjh/
输尿管炎	sngy/
输尿管异位开口	sngywkk/
输尿管肿瘤	sngzl/
蔬菜皮炎	scpy/
鼠螨叮咬	smdy/
鼠咬热	syr/
束支折返性室性心动过速	szzfxsxxdgs/
双侧肾缺如	scsqr/
双侧束支传导阻滞	scszcdzz/
双分支阻滞	sfzzz/
双胃	sw/
双向性室性心动过速	sxxsxxdgs/
双眼上斜肌麻痹	sysxjmb/
双重输尿管	szsng/
水、电解质紊乱伴发的精神障碍	s_djzwlbfdjsza/
水痘肺炎	sdfy/
水痘性角膜炎	sdxjmy/
水疱性远端指炎	spxydzy/
水痛症	stz/
睡眠呼吸暂停综合征	smhxztzhz/
睡眠障碍	smza/
斯特奇-韦伯综合征	stq_wbzhz/
四川并殖吸虫病	scbzxcb/
松节油皮炎	sjypy/
松毛虫病骨关节病	smcbggjb/
松毛虫皮炎	smcpy_6962/
苏格兰脑炎	sglny/
酸碱灼伤	sjzs/
髓单核细胞白血病	sdhxbbxb/
髓过氧化物酶缺乏症	sgyhwmqfz/
髓母细胞瘤	smxbl_6967/
髓内肿瘤	snzl/
髓性多汗症	sxdhz/
梭形细胞脂肪瘤	sxxbzfl/
锁骨下动脉-腋动脉瘤	sgxdm_ydml/
Terrien角膜边缘性变性	terrienjmbyxbx/
Terson综合征	tersonzhz/
Theodore上方角膜缘角结膜炎	theodoresfjmyjjmy/
Thygeson浅层点状角膜病变	thygesonqcdzjmbb/
弹性假黄瘤	dxjhl/
胎儿生长受限	tescsx/
胎儿乙醇综合征	teyczhz/
胎粪吸入综合征	tfxrzhz/
胎粪性便秘	tfxbm/
胎记	tj_6981/
胎膜早破	tmzp/
苔藓样结核疹	txyjhz/
苔藓样念珠状疹	txynzzz/
炭疽	tj_6985/
糖尿病	tnb/
糖尿病伴发的葡萄膜炎	tnbbfdptmy/
糖尿病合并低血糖	tnbhbdxt/
糖尿病和高血压	tnbhgxy/
糖尿病心脏病	tnbxzb/
糖尿病性视网膜病变	tnbxswmbb/
糖尿病性胃轻瘫	tnbxwqt/
糖尿病性周围神经病	tnbxzwsjb/
糖原贮积病Ⅰ型	tyzjb_x/
糖原贮积病Ⅱ型	tyzjb_x_6995/
糖原贮积病Ⅴ型	tyzjb_x_6996/
特发性迟发性免疫球蛋白缺乏症	tfxcfxmyqdbqfz/
特发性大网膜节段性梗死	tfxdwmjdxgs/
特发性低促性腺激素性性腺功能减退症	tfxdcxxjsxxxgnjtz/
特发性滴状色素减少症	tfxdzssjsz/
特发性癫痫综合征	tfxdxzhz/
特发性关节痛综合征	tfxgjtzhz/
特发性黄斑裂孔	tfxhblk/
特发性急性小管间质性肾炎	tfxjxxgjzxsy/
特发性尿钙增多症	tfxngzdz/
特发性皮肤钙化病	tfxpfghb/
特发性室性心动过速	tfxsxxdgs/
特发性嗜酸性粒细胞增多综合征	tfxssxlxbzdzhz/
特发性心室颤动	tfxxscd/
疼痛性脂肪疝	ttxzfs/
锑及其化合物引起的皮肤病	tjqhhwyqdpfb/
锑末沉着症	tmczz/
天冬氨酰葡萄糖胺尿症	tdaxpttanz/
铁尘肺	tcf/
铜绿假单胞菌感染	tljdbjgr/
铜绿假单胞菌性角膜炎	tljdbjxjmy/
铜绿色假单胞菌肺炎	tlsjdbjfy/
铜绿色假单胞菌脑膜炎	tlsjdbjnmy/
铜中毒引起的溶血性贫血	tzdyqdrxxpx/
童年情绪障碍	tnqxza/
童年社会功能障碍	tnshgnza/
痛性青紫综合征	txqzzhz/
头部鳞状细胞癌	tblzxba/
头皮脓疱糜烂性皮病	tpnpmlxpb/
头皮损伤	tpss/
投掷运动	tzyd/
透明丝孢霉病	tmsbmb/
透明细胞汗腺腺瘤	tmxbhxxl/
透明细胞棘皮瘤	tmxbjpl/
吞噬功能缺陷病	tsgnqxb/
吞咽困难	tykn/
臀上皮神经干痛	tspsjgt/
臀位难产	twnc/
脱水	ts/
脱屑性红皮病	txxhpb/
脱屑性间质肺炎	txxjzfy/
绞架性骨折或外伤性枢椎椎弓骨折	jjxgzhwsxszzggz/
切除术后内疝	qcshns/
蛙粪霉病	wfmb/
外伤性低颅内压综合征	wsxdlnyzhz/
外伤性脑脊液漏	wsxnjyl/
外伤性脑膜炎	wsxnmy/
外伤性脑脓肿	wsxnnz/
外伤性脾破裂	wsxppl/
外伤性乳房血肿	wsxrfxz/
外伤性乳房脂肪坏死	wsxrfzfhs/
外阴阿米巴病	wyambb/
外阴表皮样囊肿	wybpynz/
外阴大汗腺瘤	wydhxl/
外阴丹毒	wydd/
外阴恶性横纹肌样瘤	wyexhwjyl/
外阴恶性颗粒细胞瘤	wyexklxbl/
外阴恶性淋巴瘤	wyexlbl/
外阴恶性神经鞘瘤	wyexsjql/
外阴恶性纤维组织细胞瘤	wyexxwzzxbl/
外阴汗管瘤	wyhgl/
外阴汗腺腺癌	wyhxxa/
外阴黑色棘皮症	wyhsjpz/
外阴黑色素瘤	wyhssl/
外阴横纹肌肉瘤	wyhwjrl/
外阴滑膜肉瘤	wyhmrl/
外阴基底细胞癌	wyjdxba/
外阴急性蜂窝组织炎	wyjxfwzzy/
外阴假上皮瘤样增生	wyjsplyzs/
外阴疖病	wyjb/
外阴接触性皮炎	wyjcxpy/
外阴结核	wyjh/
外阴浸润性鳞癌	wyjrxla/
外阴卡波西肉瘤	wykbxrl/
外阴颗粒性肌母细胞瘤	wyklxjmxbl/
外阴克罗恩病	wykleb/
外阴溃疡	wyky/
外阴淋巴管瘤	wylbgl/
外阴隆凸性皮肤纤维肉瘤	wyltxpfxwrl/
外阴卵黄囊瘤	wylhnl/
外阴毛囊炎	wymny/
外阴梅克尔细胞癌	wymkexba/
外阴蛲虫病	wyncb/
外阴黏膜白斑	wynmbb/
外阴佩吉特病	wypjtb/
外阴皮肤脂溢性皮炎	wypfzyxpy/
外阴平滑肌瘤	wyphjl/
外阴平滑肌肉瘤	wyphjrl/
外阴前庭炎	wyqty/
外阴乳头状瘤	wyrtzl/
外阴软纤维瘤	wyrxwl/
外阴色素痣	wyssz/
外阴上皮样肉瘤	wyspyrl/
外阴烧伤、烫伤和化学损伤	wyss_tshhxss/
外阴神经鞘瘤	wysjql/
外阴神经纤维瘤	wysjxwl/
外阴神经性皮炎	wysjxpy/
外阴湿疹	wysz/
外阴天疱疮	wytpc/
外阴痛	wyt/
外阴纤维瘤	wyxwl/
外阴纤维肉瘤	wyxwrl/
外阴腺鳞癌	wyxla/
外阴腺泡状软组织肉瘤	wyxpzrzzrl/
外阴象皮肿	wyxpz/
外阴血管瘤	wyxgl/
外阴血管外皮细胞瘤	wyxgwpxbl/
外阴血吸虫病	wyxxcb/
外阴银屑病	wyyxb/
外阴硬化性苔藓	wyyhxtx/
外阴尤因肉瘤	wyyyrl/
外阴疣状癌	wyyza/
外阴疣状黄瘤	wyyzhl/
外阴早期浸润性鳞癌	wyzqjrxla/
外阴脂肪瘤	wyzfl/
外阴脂肪肉瘤	wyzfrl/
外阴中肾管囊肿	wyzsgnz/
外阴肿瘤合并妊娠	wyzlhbrs/
外阴转移性癌	wyzyxa/
外源性光感性皮炎	wyxggxpy/
网状青斑	wzqb/
网状青斑和青斑性血管炎	wzqbhqbxxgy/
微囊肿腺癌	wnzxa/
微小病变型肾病	wxbbxsb_7119/
微小度数斜视	wxdsxs/
微小核糖核酸病毒性角膜炎	wxhthsbdxjmy/
微血管病性溶血性贫血	wxgbxrxxpx/
韦格内肉芽肿	wgnryz/
韦格纳肉芽肿	wgnryz_7124/
韦格纳肉芽肿性巩膜炎	wgnryzxgmy/
韦尼克脑病	wnknb/
围绝经期功能失调性子宫出血	wjjqgnsdxzgcx/
围绝经期前后的外阴白色病变	wjjqqhdwybsbb/
围绝经期综合征	wjjqzhz/
围生期心肌病	wsqxjb/
围术期伴发的精神障碍	wsqbfdjsza/
维生素A过多病	wssagdb/
维生素B2缺乏病	wssb2qfb/
尾神经丛痛	wsjct/
尾痛症	wtz/
尾蚴性皮炎	wyxpy/
委内瑞拉马脑炎	wnrlmny/
萎缩纹	wsw/
未分化结缔组织病	wfhjdzzb/
胃肠道癌皮肤转移	wcdapfzy/
胃肠道癌转移卵巢	wcdazylc/
胃恶性淋巴瘤	wexlbl/
胃反应性淋巴增生	wfyxlbzs/
胃隔膜	wgm/
胃畸胎瘤	wjtl/
胃急性扩张	wjxkz/
胃溃疡出血	wkycx/
胃溃疡性穿孔	wkyxck/
胃类癌瘤	wlal/
胃内异物	wnyw/
胃黏膜脱垂	wnmtc/
胃石症	wsz/
胃食管反流病	wsgflb/
胃脂肪瘤	wzfl/
窝状角质松解症	wzjzsjz/
沃纳综合征	wnzhz/
无功能垂体腺瘤	wgnctxl/
无功能性甲状旁腺囊肿	wgnxjzpxnz/
无汗症	whz/
无机碱皮肤损伤	wjjpfss/
无脉络膜症	wmlmz/
无排卵型功能失调性子宫出血	wplxgnsdxzgcx/
无色性色素失调症	wsxsssdz/
无痛性甲状腺炎	wtxjzxy/
无痛性心肌梗死	wtxxjgs/
无症状型心肌缺血	wzzxxjqx/
无症状性脑梗死	wzzxngs/
蜈蚣蜇伤	wgzs/
X综合征	xzhz/
垂体腺瘤	ctxl/
小儿扁脸关节脱位足异常综合征	xeblgjtwzyczhz/
西伯利亚立克次体斑疹热	xblylkctbzr/
西方马型脑炎	xfmxny/
西尼罗河热	xnlhr/
西瓦特皮肤异色病	xwtpfysb/
希尔德病	xedb/
锡尘肺	xcf/
膝关节脱位	xgjtw/
膝外侧韧带损伤	xwcrdss/
系统性红斑狼疮伴发的精神障碍	xtxhblcbfdjsza/
系统性红斑狼疮伴发的葡萄膜炎	xtxhblcbfdptmy/
系统性红斑狼疮所致脊髓病	xtxhblcszjsb_7182/
系统性血管炎所致神经损害	xtxxgyszsjsh/
细菌协同性坏疽	xjxtxhj/
细菌性阴道病	xjxydb/
下尺桡关节脱位	xcrgjtw/
下疳样脓皮病	xgynpb/
下腔静脉后输尿管	xqjmhsng/
下丘脑错构瘤	xqncgl/
下丘脑多汗症	xqndhz/
下肢动脉硬化闭塞症	xzdmyhbsz/
下肢交通静脉瓣膜关闭不全	xzjtjmbmgbbq/
下肢静脉曲张	xzjmqz/
下肢静脉血栓形成	xzjmxsxc/
夏伊-德雷格综合征	xy_dlgzhz/
先天性半侧肥大	xtxbcfd/
先天性肠闭锁	xtxcbs/
先天性大疱性鱼鳞病样红皮病	xtxdpxylbyhpb/
先天性胆总管囊肿	xtxdzgnz/
先天性短食管	xtxdsg/
先天性肺动静脉瘘	xtxfdjml/
先天性肺发育不全	xtxffybq/
先天性副肌强直症	xtxfjqzz/
先天性副舟骨	xtxfzg/
先天性腹壁肌肉发育不良	xtxfbjrfybl/
先天性肝内胆管囊状扩张症	xtxgndgnzkzz/
先天性肝囊肿	xtxgnz/
先天性肝纤维化	xtxgxwh/
先天性感觉性神经病	xtxgjxsjb/
先天性肛门直肠畸形	xtxgmzcjx/
先天性睾丸发育不全	xtxgwfybq/
先天性厚甲症	xtxhjz/
先天性环状束带	xtxhzsd/
先天性肌强直	xtxjqz/
先天性肌缺如	xtxjqr/
先天性巨大色素痣	xtxjdssz/
先天性巨输尿管	xtxjsng/
先天性髋关节外展挛缩和骨盆倾斜	xtxkgjwzlshgpqx/
先天性梅毒	xtxmd/
先天性囊状腺样畸形	xtxnzxyjx/
先天性食管狭窄	xtxsgxz/
先天性食管重复	xtxsgzf/
先天性胃出口梗阻	xtxwckgz/
先天性无虹膜	xtxwhm/
先天性膝关节脱位	xtxxgjtw/
先天性小肠闭锁和肠狭窄	xtxxcbshcxz/
先天性斜颈	xtxxj/
先天性心包缺如或缺损	xtxxbqrhqs/
先天性性联无γ-球蛋白血症	xtxxlw_qdbxz/
先天性胸腹裂孔疝	xtxxflks/
先天性胸骨后膈疝	xtxxghgs/
先天性血管萎缩性皮肤异色症	xtxxgwsxpfysz/
先天性眼球震颤	xtxyqzc/
先天性再生障碍性贫血	xtxzszaxpx/
先天性支气管肺囊肿	xtxzqgfnz/
先天性支气管囊肿	xtxzqgnz/
显微型多血管炎	xwxdxgy/
线粒体病	xltb/
线粒体脑肌病	xltnjb/
线状IgA大疱性皮肤病	xzigadpxpfb/
腺病毒性肠炎	xbdxcy/
腺病毒性肺炎	xbdxfy/
向颈段脊髓供血的根动脉缺血症候群	xjdjsgxdgdmqxzhq/
向胸腰段脊髓供血的大根动脉缺血症候群	xxydjsgxddgdmqxzhq/
项痈	xy/
橡胶制品所致的皮肤病	xjzpszdpfb/
小肠过敏性紫癜	xcgmxzd/
小肠结肠炎耶尔森菌肠炎	xcjcyyesjcy/
小肠结肠炎耶尔森菌肺炎	xcjcyyesjfy/
小肠类癌	xcla/
小肠平滑肌瘤	xcphjl/
小肠平滑肌肉瘤	xcphjrl/
小肠腺癌	xcxa/
小肠腺瘤	xcxl/
小肠血管畸形	xcxgjx/
小肠血管瘤	xcxgl/
小肠异物	xcyw/
小肠原发性恶性淋巴瘤	xcyfxexlbl/
小肠脂肪瘤	xczfl/
小袋纤毛虫病	xdxmcb/
小儿Alstrom综合征	xealstromzhz/
小儿IgA肾病	xeigasb/
小儿X-连锁高免疫球蛋白M血症	xex_lsgmyqdbmxz/
小儿X-连锁淋巴组织增生性疾病	xex_lslbzzzsxjb/
小儿X-连锁无丙种球蛋白血症	xex_lswbzqdbxz/
小儿X-连锁严重联合免疫缺陷病	xex_lsyzlhmyqxb/
小儿α1-抗胰蛋白酶缺乏症	xe1_kydbmqfz/
小儿α-地中海贫血	xe_dzhpx/
小儿β地中海贫血	xedzhpx/
小儿阿姆斯特丹型侏儒	xeamstdxzr/
小儿阿托品类中毒	xeatplzd/
小儿埃博拉病毒病	xeablbdb/
小儿埃可及柯萨奇病毒感染	xeakjksqbdgr/
小儿埃莱尔-当洛综合征	xeale_dlzhz/
小儿爱德华兹综合征	xeadhzzhz/
小儿鞍上生殖细胞瘤	xeasszxbl/
小儿巴德-吉亚利综合征	xebd_jylzhz/
小儿巴特综合征	xebtzhz/
小儿白塞病	xebsb/
小儿白细胞黏附分子缺陷Ⅰ型	xebxbnffzqx_x/
小儿白细胞黏附分子缺陷Ⅱ型	xebxbnffzqx_x_7281/
小儿白血病	xebxb/
小儿半乳糖血症	xebrtxz/
小儿膀胱-输尿管反流综合征	xebg_sngflzhz/
小儿豹皮综合征	xebpzhz/
小儿贲门失弛缓症	xebmschz/
小儿苯丙酮尿症	xebbtnz/
小儿便秘	xebm/
小儿变形性肌张力障碍	xebxxjzlza/
小儿变应性鼻炎	xebyxby/
小儿变应性亚败血症综合征	xebyxybxzzhz/
小儿丙酸血症	xebsxz/
小儿丙型病毒性肝炎	xebxbdxgy/
小儿病毒感染性口炎	xebdgrxky/
小儿病毒相关吞噬血细胞综合征	xebdxgtsxxbzhz/
小儿病毒性心肌炎	xebdxxjy/
小儿病态窦房结综合征	xebtdfjzhz/
小儿波-杰综合征	xeb_jzhz/
小儿播散性血管内凝血	xebsxxgnnx/
小儿播散性脂肪肉芽肿综合征	xebsxzfryzzhz/
小儿伯-韦综合征	xeb_wzhz/
小儿不对称身材-矮小-性发育异常综合征	xebdcsc_ax_xfyyczhz/
小儿部分性肺静脉异位连接	xebfxfjmywlj/
小儿肠病性肢端皮炎	xecbxzdpy/
小儿肠套叠	xectd/
小儿肠吸收不良综合征	xecxsblzhz/
小儿肠系膜淋巴结结核	xecxmlbjjh/
小儿肠旋转不良	xecxzbl/
小儿常染色体显性小脑性共济失调	xecrstxxxnxgjsd/
小儿常染色体隐性小脑性共济失调	xecrstyxxnxgjsd/
小儿潮红综合征	xechzhz/
小儿成骨不全	xecgbq/
小儿成人型慢性粒细胞白血病	xecrxmxlxbbxb/
小儿抽动症	xecdz/
小儿出血性疾病	xecxxjb/
小儿出血性休克和脑病综合征	xecxxxkhnbzhz/
小儿触电与雷击	xecdylj/
小儿传染性单核细胞增多症	xecrxdhxbzdz/
小儿喘息样支气管炎	xecxyzqgy/
小儿纯红细胞再生障碍性贫血	xechxbzszaxpx/
小儿脆性X染色体	xecxxrst/
小儿错畸形	xecjx/
小儿大动脉炎	xeddmy/
小儿大动脉转位	xeddmzw/
小儿大脑半球胶质瘤	xednbqjzl/
小儿单侧肺异常透亮综合征	xedcfyctlzhz/
小儿单纯肺动脉口狭窄	xedcfdmkxz/
小儿单纯性甲状腺肿	xedcxjzxz/
小儿单纯性血尿	xedcxxn/
小儿单房性骨囊肿	xedfxgnz/
小儿胆道蛔虫症	xeddhcz/
小儿弹性假黄瘤	xedxjhl/
小儿蛋白质-能量营养不良	xedbz_nlyybl/
小儿低氯性氮质血症综合征	xedlxdzxzzhz/
小儿低钠血症	xednxz/
小儿低心排出量综合征	xedxpclzhz/
小儿低血糖	xedxt/
小儿迪格奥尔格综合征	xedgaegzhz/
小儿骶尾部畸胎瘤	xedwbjtl/
小儿地方性克汀病	xedfxktb/
小儿癫痫	xedx/
小儿癫痫发作诱发失语综合征	xedxfzyfsyzhz/
小儿碘缺乏病	xedqfb/
小儿淀粉样变性病	xedfybxb/
小儿丁型病毒性肝炎	xedxbdxgy/
小儿动力性肠梗阻	xedlxcgz/
小儿动脉导管未闭	xedmdgwb/
小儿动脉肝脏发育异常综合征	xedmgzfyyczhz/
小儿动脉瘤样骨囊肿	xedmlygnz/
小儿窦性心动过缓	xedxxdgh/
小儿窦性心动过速	xedxxdgs/
小儿窦性心律失常	xedxxlsc/
小儿短指-球状晶体异位综合征	xedz_qzjtywzhz/
小儿多发性肾小管功能障碍综合征	xedfxsxggnzazhz/
小儿多发性硬化	xedfxyh/
小儿多囊肾	xedns/
小儿多器官功能障碍综合征	xedqggnzazhz/
小儿多源性房性心动过速	xedyxfxxdgs/
小儿发育性角回综合征	xefyxjhzhz/
小儿发育性髋脱位	xefyxktw/
小儿发作性睡病	xefzxsb/
小儿发作性舞蹈手足徐动症	xefzxwdszxdz/
小儿法洛四联症	xeflslz/
小儿范科尼综合征	xefknzhz/
小儿房间隔缺损	xefjgqs/
小儿房室传导阻滞	xefscdzz/
小儿非霍奇金淋巴瘤	xefhqjlbl/
小儿非内脂性网状内皮增殖综合征	xefnzxwznpzzzhz/
小儿肥厚型心肌病	xefhxxjb/
小儿肥胖性生殖无能综合征	xefpxszwnzhz/
小儿肥胖症	xefpz/
小儿腓骨肌萎缩症	xefgjwsz/
小儿肺不张	xefbz/
小儿肺出血-肾炎综合征	xefcx_syzhz/
小儿肺动脉高压	xefdmgy/
小儿肺隔离症	xefglz/
小儿肺脓肿	xefnz/
小儿肺泡性蛋白沉积症	xefpxdbcjz/
小儿肺栓塞	xefss/
小儿肺水肿	xefsz/
小儿肺炎链球菌脑膜炎	xefylqjnmy/
小儿分离性焦虑症	xeflxjlz/
小儿腹股沟斜疝	xefggxs/
小儿腹泻病	xefxb/
小儿腹胀	xefz/
小儿干扰素-受体缺陷病	xegrs_stqxb/
小儿干燥综合征	xegzzhz/
小儿肝豆状核变性	xegdzhbx/
小儿肝母细胞瘤	xegmxbl/
小儿肝衰竭	xegsj/
小儿肝素-血小板减少-血栓形成综合征	xegs_xxbjs_xsxczhz/
小儿肝性脑病	xegxnb/
小儿肝炎再生障碍性贫血综合征	xegyzszaxpxzhz/
小儿肝硬化	xegyh/
小儿肝肿瘤	xegzl/
小儿感染性休克	xegrxxk/
小儿高磷酸酶血症	xeglsmxz/
小儿高免疫球蛋白E综合征	xegmyqdbezhz/
小儿高黏稠综合征	xegnczhz/
小儿戈谢病	xegxb/
小儿弓形腿综合征	xegxtzhz/
小儿功能性消化不良	xegnxxhbl/
小儿汞中毒	xegzd/
小儿共济失调毛细血管扩张Ⅰ型综合征	xegjsdmxxgkz_xzhz/
小儿共济失调毛细血管扩张综合征	xegjsdmxxgkzzhz/
小儿孤独症	xegdz/
小儿骨肉瘤	xegrl/
小儿骨软骨瘤	xegrgl/
小儿骨髓增生异常综合征	xegszsyczhz/
小儿骨硬化病	xegyhb/
小儿骨与关节结核	xegygjjh/
小儿关节过度活动综合征	xegjgdhdzhz/
小儿关节弯曲综合征	xegjwqzhz/
小儿胱氨酸病	xegasb/
小儿过敏性紫癜肾炎	xegmxzdsy/
小儿过敏症	xegmz/
小儿海蓝组织细胞增生症	xehlzzxbzsz/
小儿黑酸尿综合征	xehsnzhz/
小儿横纹肌肉瘤	xehwjrl/
小儿红白血病	xehbxb/
小儿后颅窝型脑积水综合征	xehlwxnjszhz/
小儿后尿道瓣膜	xehndbm/
小儿呼吸道合胞病毒肺炎	xehxdhbbdfy/
小儿呼吸衰竭	xehxsj/
小儿坏死性龈口炎	xehsxyky/
小儿黄疸肝脏色素沉着综合征	xehdgzssczzhz/
小儿回盲肠综合征	xehmczhz/
小儿蛔虫性肠梗阻	xehcxcgz/
小儿混合性结缔组织病	xehhxjdzzb/
小儿获得性免疫缺陷综合征	xehdxmyqxzhz/
小儿获得性免疫缺陷综合征肾病	xehdxmyqxzhzsb/
小儿霍奇金病	xehqjb/
小儿肌阵挛性癫痫	xejzlxdx/
小儿基底细胞痣综合征	xejdxbzzhz/
小儿吉兰-巴雷综合征	xejl_blzhz/
小儿急进性肾小球肾炎	xejjxsxqsy/
小儿急性播散性脑脊髓炎	xejxbsxnjsy/
小儿急性肠系膜淋巴结炎	xejxcxmlbjy/
小儿急性出血性坏死性肠炎	xejxcxxhsxcy/
小儿急性非淋巴细胞性白血病	xejxflbxbxbxb/
小儿急性横贯性脊髓炎	xejxhgxjsy/
小儿急性喉气管支气管炎	xejxhqgzqgy/
小儿急性呼吸衰竭	xejxhxsj/
小儿急性化脓性关节炎	xejxhnxgjy/
小儿急性化脓性甲状腺炎	xejxhnxjzxy/
小儿急性间歇性卟啉病	xejxjxxblb/
小儿急性偏瘫	xejxpt/
小儿急性气管支气管炎	xejxqgzqgy/
小儿急性上呼吸道感染	xejxshxdgr/
小儿急性髓样白血病	xejxsybxb/
小儿急性胃炎	xejxwy/
小儿急性小脑性共济失调	xejxxnxgjsd/
小儿急性血行播散型肺结核	xejxxxbsxfjh/
小儿急性血源性骨髓炎	xejxxyxgsy/
小儿急性中毒性脑病	xejxzdxnb/
小儿脊髓前动脉综合征	xejsqdmzhz/
小儿脊髓损伤	xejsss/
小儿脊髓性肌萎缩	xejsxjws/
小儿脊柱裂	xejzl/
小儿继发性腹膜炎	xejfxfmy/
小儿继发性免疫缺陷病	xejfxmyqxb/
小儿继发性免疫性血小板减少性紫癜	xejfxmyxxxbjsxzd/
小儿继发性血小板增多症	xejfxxxbzdz/
小儿加压素分泌过多综合征	xejysfmgdzhz/
小儿家族性低血磷性佝偻病	xejzxdxlxglb/
小儿家族性非溶血性黄疸综合征	xejzxfrxxhdzhz/
小儿家族性复发性血尿综合征	xejzxffxxnzhz/
小儿家族性嗅神经-性发育不全综合征	xejzxxsj_xfybqzhz/
小儿家族性自主神经失调综合征	xejzxzzsjsdzhz/
小儿甲基丙二酸血症	xejjbesxz/
小儿甲状旁腺功能减退症	xejzpxgnjtz/
小儿甲状腺癌	xejzxa/
小儿甲状腺功能亢进症	xejzxgnkjz/
小儿贾第虫病	xejdcb/
小儿假肥大型肌营养不良	xejfdxjyybl/
小儿假膜性肠炎	xejmxcy/
小儿假性甲状旁腺功能减低症	xejxjzpxgnjdz/
小儿假性粒细胞减少症	xejxlxbjsz/
小儿尖端扭转型室性心动过速	xejdnzxsxxdgs/
小儿尖头并指趾综合征	xejtbzzzhz/
小儿结核性胸膜炎	xejhxxmy/
小儿结节病	xejjb/
小儿结节性多动脉炎	xejjxddmy/
小儿结节性甲状腺肿	xejjxjzxz/
小儿结节性硬化症	xejjxyhz/
小儿结节性硬化综合征	xejjxyhzhz/
小儿结节性脂膜炎	xejjxzmy/
小儿结膜吸吮线虫病	xejmxsxcb/
小儿近端肾小管酸中毒	xejdsxgszd/
小儿进行性骨干发育不良	xejxxggfybl/
小儿进行性骨化性肌炎	xejxxghxjy/
小儿颈交感神经麻痹综合征	xejjgsjmbzhz/
小儿颈椎融合综合征	xejzrhzhz/
小儿巨大膀胱-巨大输尿管综合征	xejdbg_jdsngzhz/
小儿巨大血小板综合征	xejdxxbzhz/
小儿巨脑畸形综合征	xejnjxzhz/
小儿巨细胞病毒肺炎	xejxbbdfy/
小儿巨幼细胞性贫血	xejyxbxpx/
小儿军团病	xejtb/
小儿军团病肾病	xejtbsb/
小儿卡肺囊虫肺炎	xekfncfy/
小儿卡斯钦-贝克病	xeksq_bkb/
小儿抗利尿激素分泌异常综合征	xeklnjsfmyczhz/
小儿抗磷脂综合征	xeklzzhz/
小儿克罗恩病	xekleb/
小儿克山病	xeksb/
小儿空鞍综合征	xekazhz/
小儿库欣综合征	xekxzhz/
小儿狂犬病	xekqb/
小儿溃疡性结肠炎	xekyxjcy/
小儿扩张型心肌病	xekzxxjb/
小儿莱施-尼汉综合征	xels_nhzhz/
小儿赖氏综合征	xelszhz/
小儿赖特综合征	xeltzhz/
小儿蓝尿布综合征	xelnbzhz/
小儿郎格罕细胞性组织细胞增生症	xelghxbxzzxbzsz/
小儿狼疮肾炎	xelcsy/
小儿类白血病反应	xelbxbfy/
小儿利斯特菌病	xelstjb/
小儿良性先天性肌弛缓综合征	xelxxtxjchzhz/
小儿两性畸形	xelxjx/
小儿淋巴细胞间质性肺炎	xelbxbjzxfy/
小儿淋巴样息肉	xelbyxr/
小儿磷酸酶过少症	xelsmgsz/
小儿流感病毒肺炎	xelgbdfy/
小儿流行性喘憋性肺炎	xelxxcbxfy/
小儿颅面骨畸形综合征	xelmgjxzhz/
小儿颅内出血	xelncx/
小儿颅内肿瘤	xelnzl/
小儿颅脑损伤	xelnss/
小儿颅咽管瘤	xelygl/
小儿卵巢肿瘤	xelczl/
小儿轮状病毒性肠炎	xelzbdxcy/
小儿脉络丛乳头状瘤	xemlcrtzl/
小儿曼氏迭宫绦虫病和曼氏裂头蚴病	xemsdgtcbhmsltyb/
小儿慢性充血性脾肿大	xemxcxxpzd/
小儿慢性大疱性疾病	xemxdpxjb/
小儿慢性肺炎	xemxfy/
小儿慢性骨髓炎	xemxgsy/
小儿慢性粒细胞白血病	xemxlxbbxb/
小儿慢性良性中性粒细胞减少症	xemxlxzxlxbjsz/
小儿慢性淋巴细胞性甲状腺炎	xemxlbxbxjzxy/
小儿慢性肉芽肿病	xemxryzb/
小儿慢性胃炎	xemxwy/
小儿慢性胰腺炎	xemxyxy/
小儿慢性硬膜下血肿	xemxymxxz/
小儿慢性支气管炎	xemxzqgy/
小儿猫叫综合征	xemjzhz/
小儿毛细支气管炎	xemxzqgy_7549/
小儿梅克尔憩室	xemkeqs/
小儿霉甘蔗中毒	xemgzzd/
小儿迷路水肿-耳性眩晕综合征	xemlsz_exxyzhz/
小儿面部红斑侏儒综合征	xembhbzrzhz/
小儿面部偏侧肥大综合征	xembpcfdzhz/
小儿面肩肱型肌营养不良	xemjgxjyybl/
小儿莫拉雷脑膜炎	xemllnmy/
小儿内脏幼虫移行症	xenzycyxz/
小儿囊性纤维性变	xenxxwxb/
小儿脑白质海绵状变性综合征	xenbzhmzbxzhz/
小儿脑挫裂伤	xencls/
小儿脑干胶质瘤	xengjzl/
小儿脑积水	xenjs/
小儿脑膜瘤	xenml/
小儿脑膜炎球菌性肾上腺综合征	xenmyqjxssxzhz/
小儿脑脓肿	xennz/
小儿脑水肿与颅内高压综合征	xenszylngyzhz/
小儿脑血管畸形	xenxgjx/
小儿脑震荡	xenzd/
小儿尼曼-皮克病	xenm_pkb/
小儿黏多糖贮积病Ⅳ型	xendtzjb_x/
小儿黏多糖贮积症	xendtzjz/
小儿尿崩症	xenbz/
小儿尿道下裂	xendxl/
小儿尿路梗阻	xenlgz/
小儿尿石症	xensz/
小儿脓胸	xenx/
小儿女性性早熟	xenxxzs/
小儿疱疹性角膜结膜炎	xepzxjmjmy/
小儿烹调综合征	xepdzhz/
小儿皮肤黏膜淋巴结综合征	xepfnmlbjzhz/
小儿脾大	xepd/
小儿脾外伤	xepws/
小儿片吸虫病	xepxcb/
小儿偏头痛	xeptt/
小儿嘌呤核苷酸磷酸化酶缺乏	xeplhgslshmqf/
小儿屏气发作	xepqfz/
小儿葡萄糖-6-磷酸脱氢酶缺乏症	xeptt_6_lstqmqfz/
小儿葡萄状肉瘤	xeptzrl/
小儿普通易变型免疫缺陷	xeptybxmyqx/
小儿期前收缩	xeqqss/
小儿槭糖尿病	xeqtnb/
小儿其他沙门菌感染	xeqtsmjgr/
小儿气管、支气管异物	xeqg_zqgyw/
小儿气胸	xeqx/
小儿迁延性肾小球肾炎	xeqyxsxqsy/
小儿迁延与慢性腹泻	xeqyymxfx/
小儿铅中毒	xeqzd/
小儿情感交叉擦腿综合征	xeqgjcctzhz/
小儿丘疹性肢皮炎综合征	xeqzxzpyzhz/
小儿球形细胞脑白质营养不良	xeqxxbnbzyybl/
小儿龋病	xeqb/
小儿全远端型肾小管酸中毒	xeqydxsxgszd/
小儿醛固酮过多症	xeqgtgdz/
小儿热性惊厥	xerxjj/
小儿人类疱疹病毒6，7，8型感染性疾病	xerlpzbd6_7_8xgrxjb/
小儿人类细小病毒B19感染	xerlxxbdb19gr/
小儿溶血尿毒综合征	xerxndzhz/
小儿溶血性贫血	xerxxpx/
小儿乳糜泻	xermx/
小儿软骨发育不全	xergfybq/
小儿软骨外胚层发育不全综合征	xergwpcfybqzhz/
小儿软骨营养障碍-血管瘤综合征	xergyyza_xglzhz/
小儿软组织肉瘤	xerzzrl/
小儿散发性甲状腺肿	xesfxjzxz/
小儿色素沉着息肉综合征	xessczxrzhz/
小儿色素荨麻疹	xessqmz/
小儿色素失调症	xesssdz/
小儿神经白塞综合征	xesjbszhz/
小儿神经管畸形	xesjgjx/
小儿神经母细胞瘤	xesjmxbl/
小儿神经皮肤综合征	xesjpfzhz/
小儿神经纤维瘤病	xesjxwlb/
小儿神经性贪食	xesjxts/
小儿神经性厌食	xesjxys/
小儿神经源性膀胱	xesjyxbg/
小儿肾病综合征	xesbzhz/
小儿肾淀粉样变性	xesdfybx/
小儿肾结核	xesjh/
小儿肾静脉血栓形成	xesjmxsxc/
小儿肾上腺皮质功能不全	xessxpzgnbq/
小儿肾上腺皮质与髓质增生并存综合征	xessxpzyszzsbczhz/
小儿肾小管-间质肾炎	xesxg_jzsy/
小儿肾性尿崩症	xesxnbz/
小儿肾性贫血	xesxpx/
小儿肾性糖尿	xesxtn/
小儿肾血管性高血压	xesxgxgxy/
小儿渗出性多形性红斑	xescxdxxhb/
小儿生长激素缺乏症	xescjsqfz/
小儿生殖细胞瘤	xeszxbl/
小儿石膏综合征	xesgzhz/
小儿食管异物	xesgyw/
小儿食物变态反应	xeswbtfy/
小儿食物中毒	xeswzd/
小儿史-约综合征	xes_yzhz/
小儿视神经胶质瘤	xessjjzl/
小儿视网膜母细胞瘤	xeswmmxbl/
小儿视网膜色素变性-肥胖-多指综合征	xeswmssbx_fp_dzzhz/
小儿室间隔缺损	xesjgqs/
小儿室间隔完整型肺动脉闭锁	xesjgwzxfdmbs/
小儿室性心动过速	xesxxdgs/
小儿嗜铬细胞瘤	xesgxbl/
小儿嗜血流感杆菌肺炎	xesxlggjfy/
小儿嗜血性流行性感冒杆菌脑膜炎	xesxxlxxgmgjnmy/
小儿手-心畸形综合征	xes_xjxzhz/
小儿输尿管脱垂	xesngtc/
小儿双唇综合征	xesczhz/
小儿水杨酸盐类中毒	xesysylzd/
小儿松果体区肿瘤	xesgtqzl/
小儿髓母细胞瘤	xesmxbl/
小儿锁骨颅骨发育不全综合征	xesglgfybqzhz/
小儿唐氏综合征	xetszhz/
小儿糖尿病	xetnb/
小儿糖尿病肾病	xetnbsb/
小儿糖吸收不良	xetxsbl/
小儿糖原贮积病Ⅰ型	xetyzjb_x/
小儿糖原贮积病Ⅱ型	xetyzjb_x_7666/
小儿糖原贮积病Ⅲ型	xetyzjb_x_7667/
小儿糖原贮积病Ⅳ型	xetyzjb_x_7668/
小儿糖原贮积病Ⅴ型	xetyzjb_x_7669/
小儿糖原贮积病Ⅵ型	xetyzjb_x_7670/
小儿糖原贮积病Ⅶ型	xetyzjb_x_7671/
小儿糖原贮积病Ⅸ型	xetyzjb_x_7672/
小儿烫伤	xets/
小儿特发性肺含铁血黄素沉着症	xetfxfhtxhsczz/
小儿特发性肺纤维化	xetfxfxwh/
小儿特发性尿钙增多症	xetfxngzdz/
小儿特发性室性心动过速	xetfxsxxdgs/
小儿特发性血小板减少性紫癜	xetfxxxbjsxzd/
小儿铁粒幼红细胞性贫血	xetlyhxbxpx/
小儿同型胱氨酸尿症	xetxgasnz/
小儿铜缺乏症综合征	xetqfzzhz/
初潮痛经	cctj/
小儿透析失衡综合征	xetxshzhz/
小儿脱屑性肺炎	xetxxfy/
小儿外部性脑积水	xewbxnjs/
小儿外源性变应性肺泡炎	xewyxbyxfpy/
小儿完全性肺静脉异位连接	xewqxfjmywlj/
小儿晚发性维生素K缺乏病	xewfxwsskqfb/
小儿韦格纳肉芽肿	xewgnryz/
小儿维生素A缺乏病	xewssaqfb/
小儿维生素C缺乏病	xewsscqfb/
小儿维生素D缺乏性佝偻病	xewssdqfxglb/
小儿维生素D缺乏性手足搐搦症	xewssdqfxszcnz/
小儿维生素E缺乏病	xewsseqfb/
小儿维斯科特-奥尔德里奇综合征	xewskt_aedlqzhz/
小儿胃肠道异物及异物性肠梗阻	xewcdywjywxcgz/
小儿胃结块症	xewjkz/
小儿无甲状腺性克汀病	xewjzxxktb/
小儿无菌性脑膜炎综合征	xewjxnmyzhz/
小儿无脾综合征	xewpzhz/
小儿戊型病毒性肝炎	xewxbdxgy/
小儿系统性红斑狼疮	xextxhblc/
小儿细胞外胆固醇沉着综合征	xexbwdgcczzhz/
小儿细菌感染性口炎	xexjgrxky/
小儿细菌性痢疾	xexjxlj/
小儿下腔静脉阻塞综合征	xexqjmzszhz/
小儿下丘脑错构瘤	xexqncgl/
小儿先天性白细胞颗粒异常综合征	xextxbxbklyczhz/
小儿先天性胆总管囊肿	xextxdzgnz/
小儿先天性肺囊肿	xextxfnz/
小儿先天性肝囊肿	xextxgnz/
小儿先天性高氨血症	xextxgaxz/
小儿先天性睾丸发育不全	xextxgwfybq/
小儿先天性光敏感性卟啉症	xextxgmgxblz/
小儿先天性红细胞生成异常性贫血	xextxhxbscycxpx/
小儿先天性肌强直综合征	xextxjqzzhz/
小儿先天性甲状腺功能减低症	xextxjzxgnjdz/
小儿先天性面肌双瘫综合征	xextxmjstzhz/
小儿先天性肾病综合征	xextxsbzhz/
小儿先天性肾上腺皮质增生症	xextxssxpzzsz/
小儿先天性肾盂输尿管连接部梗阻	xextxsysngljbgz/
小儿先天性外胚层发育不良综合征	xextxwpcfyblzhz/
小儿先天性斜颈	xextxxj/
小儿先天性直肠肛门畸形	xextxzcgmjx/
小儿先天性侏儒痴呆综合征	xextxzrcdzhz/
小儿先天性主动脉瓣狭窄	xextxzdmbxz/
小儿纤维性骨营养不良综合征	xexwxgyyblzhz/
小儿限制型心肌病	xexzxxjb/
小儿腺病毒性肺炎	xexbdxfy/
小儿腺苷脱氨酶缺乏	xexgtamqf/
小儿消化道出血	xexhdcx/
小儿心搏呼吸骤停与心肺复苏术	xexbhxztyxffss/
小儿心房颤动	xexfcd/
小儿心房扑动	xexfpd/
小儿心肌炎	xexjy/
小儿心力衰竭	xexlsj/
小儿心律失常	xexlsc/
小儿心面综合征	xexmzhz/
小儿心内膜弹力纤维增生症	xexnmdlxwzsz/
小儿锌缺乏症	xexqfz/
小儿新变异型克罗伊茨费尔特-雅各布病	xexbyxklycfet_ygbb/
小儿星形细胞瘤	xexxxbl/
小儿雄激素不敏感综合征	xexjsbmgzhz/
小儿休克	xexk/
小儿选择性免疫球蛋白A缺乏症	xexzxmyqdbaqfz/
小儿选择性免疫球蛋白G亚类缺陷病	xexzxmyqdbgylqxb/
小儿学校恐怖症	xexxkbz/
小儿血管-骨肥大综合征	xexg_gfdzhz/
小儿血管角质瘤综合征	xexgjzlzhz/
小儿血管瘤	xexgl/
小儿血管瘤血小板减少综合征	xexglxxbjszhz/
小儿血管免疫母细胞淋巴结病	xexgmymxblbjb/
小儿血管网状细胞瘤	xexgwzxbl/
小儿血管性血友病	xexgxxyb/
小儿血清病	xexqb/
小儿血栓性血小板减少性紫癜	xexsxxxbjsxzd/
小儿血小板释放功能缺陷性疾患	xexxbsfgnqxxjh/
小儿血小板无力症	xexxbwlz/
小儿血友病	xexyb/
小儿牙本质生长不全综合征	xeybzscbqzhz/
小儿雅克什综合征	xeykszhz/
小儿雅司病	xeysb/
小儿亚急性骨髓炎	xeyjxgsy/
小儿亚急性甲状腺炎	xeyjxjzxy/
小儿亚硝酸盐中毒	xeyxsyzd/
小儿烟酸缺乏病	xeysqfb/
小儿烟雾病	xeywb/
小儿淹溺	xeyn/
小儿严重急性呼吸综合征	xeyzjxhxzhz/
小儿言语和语言障碍	xeyyhyyza/
小儿炎症性肠病	xeyzxcb/
小儿眼-耳-脊椎综合征	xey_e_jzzhz/
小儿眼-脑-肾综合征	xey_n_szhz/
小儿药物变态反应	xeywbtfy/
小儿药物性皮炎	xeywxpy/
小儿药物性肾损害	xeywxssh/
小儿药物诱发的溶血性贫血	xeywyfdrxxpx/
小儿叶酸缺乏病	xeysqfb_7778/
小儿一氧化碳中毒	xeyyhtzd/
小儿衣原体肺炎	xeyytfy/
小儿遗传性大疱性表皮松解症	xeycxdpxbpsjz/
小儿遗传性共济失调	xeycxgjsd/
小儿遗传性果糖不耐受	xeycxgtbns/
小儿遗传性痉挛性截瘫	xeycxjlxjt/
小儿遗传性口形细胞增多症	xeycxkxxbzdz/
小儿遗传性慢性进行性肾炎	xeycxmxjxxsy/
小儿遗传性球形红细胞增多症	xeycxqxhxbzdz/
小儿遗传性椭圆形红细胞增多症	xeycxtyxhxbzdz/
小儿遗传性血管神经性水肿	xeycxxgsjxsz/
小儿遗尿	xeyn_7790/
小儿乙型肝炎病毒相关肾炎	xeyxgybdxgsy/
小儿异染性脑白质营养不良	xeyrxnbzyybl/
小儿隐睾症	xeygz/
小儿营养不良性消瘦	xeyyblxxs/
小儿硬化性胆管炎	xeyhxdgy/
小儿硬脊膜外脓肿	xeyjmwnz/
小儿硬脑膜外脓肿	xeynmwnz/
小儿硬脑膜外血肿	xeynmwxz/
小儿硬脑膜下血肿	xeynmxxz/
小儿硬皮病	xeypb/
小儿幽门螺杆菌感染	xeymlgjgr/
小儿尤因肉瘤	xeyyrl/
小儿有机磷农药中毒	xeyjlnyzd/
小儿右肺中叶综合征	xeyfzyzhz/
小儿右室双出口	xeyssck/
小儿预激综合征	xeyjzhz/
小儿原发型肺结核	xeyfxfjh/
小儿原发性膀胱输尿管反流	xeyfxbgsngfl/
小儿原发性腹膜炎	xeyfxfmy/
小儿原发性甲状旁腺功能亢进症	xeyfxjzpxgnkjz/
小儿原发性免疫缺陷病	xeyfxmyqxb/
小儿原发性脑干损伤	xeyfxngss/
小儿原发性血小板增多症	xeyfxxxbzdz/
小儿远端肾小管酸中毒	xeydsxgszd/
小儿月经过多	xeyjgd/
小儿阅读障碍	xeydza/
小儿再发性腹痛	xezfxft/
小儿再发性呕吐	xezfxot/
小儿再生障碍性贫血	xezszaxpx/
小儿早老症	xezlz/
小儿粘连性肠梗阻	xezlxcgz/
小儿真菌感染性口炎	xezjgrxky/
小儿真菌性肺炎	xezjxfy/
小儿阵发性室上性心动过速	xezfxssxxdgs/
小儿阵发性室性心动过速	xezfxsxxdgs/
小儿阵发性睡眠性血红蛋白尿症	xezfxsmxxhdbnz/
小儿支气管肺发育不全	xezqgffybq/
小儿支气管肺炎	xezqgfy/
小儿支气管扩张	xezqgkz/
小儿支气管哮喘	xezqgxc/
小儿脂肪吸收不良	xezfxsbl/
小儿直肠脱垂	xezctc/
小儿指甲-髌骨综合征	xezj_bgzhz/
小儿致心律失常性右室心肌病	xezxlscxysxjb/
小儿中毒型痢疾	xezdxlj/
小儿中暑和暑热症	xezshsrz/
小儿重症肌无力	xezzjwl/
小儿周期性低血钾性麻痹	xezqxdxjxmb/
小儿周期性高血钾性麻痹	xezqxgxjxmb/
小儿周期性正常血钾性麻痹	xezqxzcxjxmb/
小儿周围淋巴结结核	xezwlbjjh/
小儿皱梅腹综合征	xezmfzhz/
小儿侏儒-视网膜萎缩-耳聋综合征	xezr_swmws_elzhz/
小儿珠蛋白生成障碍性贫血	xezdbsczaxpx/
小儿猪带绦虫病和囊虫病	xezdtcbhncb/
小儿注意缺陷障碍	xezyqxza/
小儿转移性骨肿瘤	xezyxgzl/
小儿椎管内肿瘤	xezgnzl/
小儿锥体功能不良综合征	xeztgnblzhz/
小儿紫斑湿疹综合征	xezbszzhz/
小儿自律性房性心动过速	xezlxfxxdgs/
小儿自身免疫性淋巴细胞增生综合征	xezsmyxlbxbzszhz/
小儿自身免疫性溶血性贫血	xezsmyxrxxpx/
小儿纵隔囊肿及肿瘤	xezgnzjzl/
小儿纵隔压迫综合征	xezgypzhz/
小儿阻塞性睡眠呼吸暂停	xezsxsmhxzt/
小儿柞蚕蛹性脑病综合征	xezcyxnbzhz/
小汗腺汗管纤维腺瘤	xhxhgxwxl/
小汗腺汗囊肿	xhxhnz/
小汗腺血管错构瘤	xhxxgcgl/
小汗腺痣	xhxz/
小颌畸形综合征	xhjxzhz/
小棘毛壅病	xjmyb/
小棘苔藓	xjtx/
小螺菌感染	xljgr/
小脑幕脑膜瘤	xnmnml/
小脑脑桥角脑膜瘤	xnnqjnml/
小提琴手颈部皮炎	xtqsjbpy/
小腿动脉损伤	xtdmss/
小腿红绀病	xthgb/
小网膜囊疝	xwmns/
心包内恶性畸胎瘤	xbnexjtl/
心包切开术后综合征	xbqkshzhz/
心包胸腺瘤	xbxxl/
心动过速性心肌病	xdgsxxjb/
心-耳综合征	x_ezhz/
心房颤动	xfcd/
心房内传导阻滞	xfncdzz/
心房内折返性心动过速	xfnzfxxdgs/
心房扑动	xfpd/
心肌桥	xjq/
心脏乳头样弹性纤维瘤	xzrtydxxwl/
心脏脂肪瘤	xzzfl/
心脏直视手术所致神经疾病	xzzsssszsjjb/
心脏骤停与心肺脑复苏	xzztyxfnfs/
心脏转移瘤	xzzyl/
心脏转移性恶性黑色素瘤	xzzyxexhssl/
锌及其化合物引起的皮肤病	xjqhhwyqdpfb_7888/
新生儿B链球菌感染	xseblqjgr/
新生儿Rh血型不合溶血病	xserhxxbhrxb/
新生儿Wilson-Mikity综合征	xsewilson_mikityzhz/
新生儿出血症	xsecxz/
新生儿单纯疱疹病毒感染	xsedcpzbdgr/
新生儿低钠血症	xsednxz/
新生儿低体温	xsedtw/
新生儿低血糖症	xsedxtz/
新生儿反应低下	xsefydx/
新生儿高血糖症	xsegxtz/
新生儿佝偻病	xseglb/
新生儿寒冷损伤综合征	xsehlsszhz/
新生儿红细胞增多症-高黏滞度综合征	xsehxbzdz_gnzdzhz/
新生儿喉喘鸣	xsehcm/
新生儿坏死性小肠结肠炎	xsehsxxcjcy/
新生儿急性肾功能衰竭	xsejxsgnsj/
新生儿柯萨奇病毒B感染	xseksqbdbgr/
新生儿泌尿系统感染	xsemnxtgr/
新生儿尿布皮炎	xsenbpy/
新生儿破伤风	xsepsf/
新生儿迁延性胆汁淤积性黄疸	xseqyxdzyjxhd/
新生儿青紫	xseqz/
新生儿生理性黄疸	xseslxhd/
新生儿失血性贫血	xsesxxpx/
新生儿头颅血肿	xsetlxz/
新生儿晚期代谢性酸中毒	xsewqdxxszd/
新生儿胃穿孔	xsewck/
新生儿先天性胆道闭锁	xsextxddbs/
新生儿先天性膈疝	xsextxgs/
新生儿先天性弓形体感染	xsextxgxtgr/
新生儿消化道重复症	xsexhdzfz/
新生儿心肌炎	xsexjy/
新生儿心律失常	xsexlsc/
新生儿休克	xsexk/
新生儿血小板减少性紫癜	xsexxbjsxzd/
新生儿咽下综合征	xseyxzhz/
新生儿衣原体感染	xseyytgr/
新生儿乙型肝炎	xseyxgy/
新生儿紫癜	xsezd/
新生血管性青光眼	xsxgxqgy/
新型隐球菌性脑膜炎	xxyqjxnmy/
星形病毒胃肠炎	xxbdwcy/
行军性血红蛋白尿	xjxxhdbn/
性病神经症	xbsjz/
性病相关性胃肠道感染	xbxgxwcdgr/
性厌恶	xye/
胸、腰椎椎体单纯性、楔形压缩骨折	x_yzztdcx_xxysgz/
胸壁骨肿瘤	xbgzl/
胸壁皮下气肿	xbpxqz/
胸壁软组织畸形	xbrzzjx/
胸壁软组织损伤	xbrzzss/
胸壁软组织肿瘤	xbrzzzl/
胸壁深部软组织感染	xbsbrzzgr/
胸部阿米巴病	xbambb/
胸部放线菌病	xbfxjb/
胸部丝虫病	xbscb/
胸长神经卡压症	xcsjkyz/
胸导管损伤	xdgss/
胸腹主动脉动脉瘤	xfzdmdml/
胸骨骨髓炎	xggsy/
胸内肾	xns/
胸内异物	xnyw/
胸腺癌	xxa_7951/
胸腺类癌	xxla/
胸腺小细胞癌	xxxxba/
胸椎后纵韧带骨化症	xzhzrdghz/
胸椎黄韧带骨化症	xzhrdghz/
胸椎间盘突出症	xzjptcz/
须疮	xc_7957/
须癣	xx_7958/
嗅沟脑膜瘤	xgnml/
嗅觉障碍	xjza/
眩晕	xy_7961/
学习技能发育障碍	xxjnfyza/
血管角化瘤	xgjhl/
血管球瘤	xgql/
血管损伤	xgss/
血管性痴呆	xgxcd/
血管性帕金森综合征	xgxpjszhz/
血管炎性周围神经病	xgyxzwsjb/
血管周细胞瘤	xgzxbl/
血红蛋白C病	xhdbcb/
血红蛋白D病	xhdbdb/
血红蛋白E病	xhdbeb/
血红蛋白M病	xhdbmb/
血栓性静脉炎	xsxjmy/
血栓性浅静脉炎	xsxqjmy/
血小板促凝活性异常	xxbcnhxyc/
血小板减少性紫癜	xxbjsxzd/
血小板型假性血管性血友病	xxbxjxxgxxyb/
血友病乙	xyby/
寻常痤疮	xccc/
寻常狼疮	xclc/
寻常性鱼鳞病	xcxylb/
寻常疣	xcy/
蕈样真菌病	xyzjb/
蕈样真菌病和Sezary综合征	xyzjbhsezaryzhz/
幼年型关节强硬性脊椎炎	ynxgjqyxjzy/
支气管发育不全	zqgfybq/
结节性液化性脂膜炎	jjxyhxzmy/
压力性尿失禁	ylxnsj/
亚急性联合变性	yjxlhbx/
亚急性皮肤红斑狼疮	yjxpfhblc/
亚急性硬化性全脑炎	yjxyhxqny/
亚急性硬膜外血肿	yjxymwxz/
亚临床甲状腺功能减退症	ylcjzxgnjtz/
亚临床甲状腺功能亢进	ylcjzxgnkj/
亚临床型克汀病	ylcxktb/
烟雾病	ywb/
延髓性麻痹	ysxmb/
严重肝病引起获得性凝血因子异常	yzgbyqhdxnxyzyc/
严重急性呼吸综合征	yzjxhxzhz/
言语障碍	yyza/
岩骨斜坡脑膜瘤	ygxpnml/
岩藻糖苷贮积症	yztgzjz/
炎性肠病性关节炎相关巩膜炎	yxcbxgjyxggmy/
炎性乳腺癌	yxrxa/
炎症后弹力纤维松解伴皮肤松弛	yzhdlxwsjbpfsc/
炎症后黑变病	yzhhbb/
炎症相关性青光眼	yzxgxqgy/
炎症性肠道疾病及其伴发的葡萄膜炎	yzxcdjbjqbfdptmy/
炎症性腹主动脉瘤	yzxfzdml/
盐敏感性高血压	ymgxgxy/
眼部神经纤维瘤病	ybsjxwlb/
眼部猪囊尾蚴病	ybznwyb/
眼底血管样条纹	ydxgytw/
眼弓蛔虫病	yghcb/
眼弓形体病	ygxtb/
眼肌麻痹性偏头痛	yjmbxptt/
眼假组织胞质菌病综合征	yjzzbzjbzhz/
眼睑基底细胞癌	yjjdxba/
眼睑痉挛-口下颏部肌张力障碍	yjjl_kxkbjzlza/
眼眶淀粉样变性	ykdfybx/
眼眶非霍奇金恶性淋巴瘤	ykfhqjexlbl/
眼眶非霍奇金恶性淋巴肿瘤	ykfhqjexlbzl/
眼眶蜂窝织炎	ykfwzy/
眼眶骨化纤维瘤	ykghxwl/
眼眶骨瘤	ykgl/
眼眶骨纤维异常增殖症	ykgxwyczzz/
眼眶畸胎瘤	ykjtl/
眼眶寄生虫囊肿	ykjscnz/
眼眶淋巴管瘤	yklbgl/
眼眶内海绵状血管瘤	yknhmzxgl/
眼眶内静脉曲张	yknjmqz/
眼眶脑膜-脑膨出	yknm_npc/
眼眶黏液囊肿	yknynz/
眼眶脓肿	yknz/
眼眶皮样囊肿	ykpynz/
眼眶平滑肌瘤	ykphjl/
眼眶神经纤维瘤	yksjxwl/
眼眶嗜酸性肉芽肿	ykssxryz/
眼眶纤维肉瘤	ykxwrl/
眼眶血管外皮瘤	ykxgwpl/
眼眶血肿	ykxz/
眼眶炎性假瘤	ykyxjl/
眼眶真菌病	ykzjb/
眼眶脂肪瘤	ykzfl/
眼眶脂肪肉瘤	ykzfrl/
眼眶转移性肿瘤	ykzyxzl/
眼类肉瘤病	ylrlb/
眼颧部褐蓝痣	yqbhlz/
眼外肌病及弱视	ywjbjrs/
眼外肌发育不全	ywjfybq/
眼外肌广泛纤维化综合征	ywjgfxwhzhz/
眼外肌外伤	ywjws/
眼外肌猪囊尾蚴病	ywjznwyb/
眼异物伤	yyws/
厌氧菌肺炎	yyjfy/
羊膜腔感染综合征	ymqgrzhz/
痒点	yd_8058/
痒性紫癜	yxzd_8059/
恙螨皮炎	ympy/
腰骶部脂肪疝	ydbzfs/
腰痛-血尿综合征	yt_xnzhz/
腰椎小关节不稳症	yzxgjbwz/
腰椎椎管狭窄症	yzzgxzz/
药物反应性甲病	ywfyxjb/
药物免疫性血小板减少性紫癜	ywmyxxxbjsxzd/
药物相关性免疫性溶血性贫血	ywxgxmyxrxxpx/
药物相关性青光眼	ywxgxqgy/
药物性狼疮	ywxlc/
夜间哮喘	yjxc/
一度房室传导阻滞	ydfscdzz/
伊藤痣	ytz/
衣原体尿路感染	yytnlgr/
医用药物中毒所致的精神障碍	yyywzdszdjsza/
医源性胆管损伤	yyxdgss/
医源性多毛症	yyxdmz/
医源性气管及主支气管损伤	yyxqgjzzqgss/
胰高糖素瘤综合征	ygtslzhz/
胰高血糖素瘤	ygxtsl/
胰瘘	yl_8080/
胰石病	ysb_8081/
胰腺假囊肿	yxjnz/
胰腺囊性纤维性变	yxnxxwxb/
胰腺真性囊肿	yxzxnz/
移行脊椎	yxjz/
移植后淋巴增殖性疾病	yzhlbzzxjb/
移植物抗宿主病	yzwkszb/
遗传性蛋白S缺陷症	ycxdbsqxz/
遗传性对称性色素异常症	ycxdcxssycz/
遗传性多发脑梗死性痴呆	ycxdfngsxcd/
遗传性多发性骨软骨瘤	ycxdfxgrgl/
遗传性耳瘘	ycxel/
遗传性粪卟啉病	ycxfblb/
遗传性感觉神经病	ycxgjsjb/
遗传性高尿酸血症	ycxgnsxz/
遗传性高铁血红蛋白血症	ycxgtxhdbxz/
遗传性抗凝血酶Ⅲ缺乏症	ycxknxm_qfz/
遗传性良性上皮内角化不良	ycxlxspnjhbl/
遗传性凝血酶原缺乏	ycxnxmyqf/
遗传性凝血因子Ⅴ缺乏症	ycxnxyz_qfz/
遗传性凝血因子Ⅶ缺乏	ycxnxyz_qf/
遗传性凝血因子ⅩⅢ缺乏	ycxnxyz__qf/
遗传性凝血因子Ⅹ缺乏	ycxnxyz_qf_8103/
遗传性凝血因子Ⅺ缺乏	ycxnxyz_qf_8104/
遗传性球形红细胞增多症	ycxqxhxbzdz/
遗传性铁粒幼细胞性贫血	ycxtlyxbxpx/
遗传性椭圆形红细胞增多症	ycxtyxhxbzdz/
遗传性纤维蛋白原缺乏症	ycxxwdbyqfz/
遗传性异常纤维蛋白原血症	ycxycxwdbyxz/
遗传性硬化性皮肤异色症	ycxyhxpfysz/
遗传性运动失调性多发性神经炎	ycxydsdxdfxsjy/
乙型肝炎病毒相关性肾炎	yxgybdxgxsy/
乙型肝炎病毒性关节炎	yxgybdxgjy/
乙型肝炎抗原血症	yxgykyxz/
乙状结肠扭转	yzjcnz/
乙状结肠造口旁沟疝	yzjczkpgs/
异常γ-球蛋白血症	yc_qdbxz/
异色性虹膜睫状体炎	ysxhmjzty/
异物伤	yws_8119/
异物性食管穿孔	ywxsgck/
阴部神经干痛	ybsjgt/
阴道白斑	ydbb/
阴道壁息肉	ydbxr/
阴道恶性苗勒管混合瘤	ydexmlghhl/
阴道鳞状上皮癌	ydlzspa/
阴道蚂蟥叮吸	ydmhdx/
阴道内胚窦瘤	ydnpdl/
阴道平滑肌肉瘤	ydphjrl/
阴道前壁膨出	ydqbpc/
阴道上皮内瘤样变	ydspnlyb/
阴道嗜血杆菌性阴道炎	ydsxgjxydy/
阴道腺癌	ydxa/
阴道腺病	ydxb/
阴道斜隔	ydxg/
阴道血管肉瘤	ydxgrl/
阴道血吸虫病	ydxxcb/
阴道异物	ydyw/
阴道转移性肿瘤	ydzyxzl/
阴道子宫内膜间质肉瘤	ydzgnmjzrl/
阴沟肠杆菌感染	ygcgjgr/
阴茎结核疹	yjjhz/
阴茎离断伤	yjlds/
阴茎扭转	yjnz/
阴茎前阴囊	yjqyn/
阴茎头包皮炎	yjtbpy/
阴囊癌	yna/
阴囊坏疽	ynhj/
阴囊损伤	ynss/
阴囊炎性癌	ynyxa/
银屑病关节炎性巩膜炎	yxbgjyxgmy/
银屑病甲	yxbj/
银屑病性关节炎	yxbxgjy/
隐匿型乳腺癌	ynxrxa/
隐匿型肾炎	ynxsy/
婴儿腹部远心性脂肪营养不良	yefbyxxzfyybl/
婴儿及儿童期癫痫及癫痫综合征	yejetqdxjdxzhz/
婴儿痉挛症	yejlz/
婴儿肉毒中毒综合征	yerdzdzhz/
婴儿纤维错构瘤	yexwcgl/
婴儿黑矇性痴呆	yehmxcd/
婴儿性骨皮质增生症	yexgpzzsz/
婴儿肢端脓疱病	yezdnpb/
婴儿肢端脓皮病	yezdnpb_8163/
婴儿指趾纤维瘤病	yezzxwlb/
婴幼儿胃食管反流	yyewsgfl/
婴幼儿型内斜视	yyexnxs/
鹦鹉热	ywr/
鹦鹉热衣原体肺炎	ywryytfy/
营养不良	yybl/
营养代谢疾病伴发的精神障碍	yydxjbbfdjsza/
营养代谢障碍疾病	yydxzajb/
硬化萎缩苔藓	yhwstx/
硬化型骨髓炎	yhxgsy/
硬化性骨髓炎	yhxgsy_8174/
硬化性脂肪肉芽肿	yhxzfryz/
硬脊膜外脓肿	yjmwnz/
硬脊膜下脓肿	yjmxnz/
硬脑膜动静脉畸形	ynmdjmjx/
硬脑膜下脓肿	ynmxnz/
硬皮症伴发的精神障碍	ypzbfdjsza/
油彩皮炎	ycpy/
油漆皮炎	yqpy/
油性肉芽肿	yxryz/
疣状皮肤结核	yzpfjh/
疣状血管瘤	yzxgl/
疣状肢端角化病	yzzdjhb/
游走脾	yzp/
游走性结节性脂膜炎	yzxjjxzmy/
右束支传导阻滞	yszcdzz/
右心房与下腔静脉平滑肌瘤	yxfyxqjmphjl/
幼淋巴细胞白血病	ylbxbbxb/
幼年黑素瘤	ynhsl/
幼年息肉	ynxr/
幼年型类天疱疮	ynxltpc/
幼年型粒-单核细胞白血病	ynxl_dhxbbxb/
幼年型慢性关节炎及其伴发的葡萄膜炎	ynxmxgjyjqbfdptmy/
幼年型慢性粒细胞白血病	ynxmxlxbbxb/
幼年型疱疹样皮炎	ynxpzypy/
幼年型皮肌炎	ynxpjy/
幼年性黄色肉芽肿	ynxhsryz/
幼年性透明纤维瘤病	ynxtmxwlb/
淤滞性皮下硬化症	yzxpxyhz/
淤滞性紫癜	yzxzd/
原发免疫性疾病相关的淋巴增殖性疾病	yfmyxjbxgdlbzzxjb/
原发气管支气管肿瘤	yfqgzqgzl/
原发性鼻腔淋巴瘤	yfxbqlbl/
原发性肠系膜肿瘤	yfxcxmzl/
原发性单克隆免疫球蛋白病	yfxdklmyqdbb/
原发性单克隆球蛋白病肾损害	yfxdklqdbbssh/
原发性腹膜癌	yfxfma/
原发性高血压	yfxgxy/
原发性高脂蛋白血症与黄瘤增生病	yfxgzdbxzyhlzsb/
原发性骨髓纤维化	yfxgsxwh/
原发性混合型冷球蛋白血症性血管炎	yfxhhxlqdbxzxxgy/
原发性急性闭角型青光眼	yfxjxbjxqgy/
原发性甲状腺恶性淋巴瘤	yfxjzxexlbl/
原发性巨球蛋白血症	yfxjqdbxz/
原发性巨球蛋白血症肾损害	yfxjqdbxzssh/
原发性卵巢绒癌	yfxlcra/
原发性慢性闭角型青光眼	yfxmxbjxqgy/
原发性皮肤滤泡中心细胞性淋巴瘤	yfxpflpzxxbxlbl/
原发性皮肤免疫细胞瘤	yfxpfmyxbl/
原发性脾淋巴瘤	yfxplbl/
原发性青少年型青光眼	yfxqsnxqgy/
原发性乳腺淋巴瘤	yfxrxlbl/
原发性腮腺淋巴瘤	yfxsxlbl/
原发性肾上腺皮质功能减退症	yfxssxpzgnjtz/
原发性渗出性淋巴瘤	yfxscxlbl/
原发性十二指肠恶性淋巴瘤	yfxsezcexlbl/
原发性食管恶性黑色素瘤	yfxsgexhssl/
原发性食管恶性淋巴瘤	yfxsgexlbl/
原发性痛经	yfxtj/
原发性系统性淀粉样变	yfxxtxdfyb/
原发性纤维蛋白溶解症	yfxxwdbrjz/
原发性限局性皮肤淀粉样变	yfxxjxpfdfyb/
原发性小肠溃疡	yfxxcky/
原发性小肠淋巴管扩张症	yfxxclbgkzz/
原发性心脏淋巴瘤	yfxxzlbl/
原发性婴幼儿型青光眼	yfxyyexqgy/
原发性中枢神经系统淋巴瘤	yfxzssjxtlbl/
圆形糠疹	yxkz/
远视	ys_8242/
月经性哮喘	yjxxc/
月经疹	yjz/
运动员胸背与腰背痛	ydyxbyybt/
运动障碍疾病	ydzajb/
甲流	jl_8247/
早期乳腺癌	zqrxa/
早期婴儿型癫痫性脑病	zqyexdxxnb/
早熟性儿童乳房肥大症	zsxetrffdz/
造影剂肾病	zyjsb/
噪声病	zsb/
增生性玻璃体视网膜病变	zsxbltswmbb/
增生性骨关节病	zsxggjb/
增生性毛根鞘瘤	zsxmgql/
增殖性红斑	zzxhb/
增殖性皮炎	zzxpy/
谵妄	zw/
掌侧化脓性腱鞘炎、滑囊炎和深间隙感染	zchnxjqy_hnyhsjxgr/
掌跖脓疱病	zznpb/
掌跖纤维瘤病	zzxwlb/
掌指骨结核	zzgjh/
蔗尘肺	zcf/
真菌过敏性哮喘	zjgmxxc/
真菌性关节炎	zjxgjy/
真菌性食管炎	zjxsgy/
枕骨下硬结性毛囊炎	zgxyjxmny/
枕颈关节损伤	zjgjss/
正常颅压脑积水	zclynjs/
正常眼压性青光眼	zcyyxqgy/
支气管肺隔离症	zqgfglz/
支气管源性囊肿	zqgyxnz/
支气管中心性肉芽肿病	zqgzxxryzb/
肢端肥大症	zdfdz/
肢端肥大症性心肌病	zdfdzxxjb/
肢端纤维角化瘤	zdxwjhl/
脂肪营养不良	zfyybl/
脂肉瘤	zrl/
脂性渐进性坏死	zxjjxhs/
脂溢性角化病	zyxjhb/
蜘蛛痣	zzz/
直接型颈动脉海绵窦瘘	zjxjdmhmdl/
职业性皮肤癌	zyxpfa/
职业性哮喘	zyxxc/
职业性硬皮病	zyxypb/
职业病	zyb/
跖管综合征	zgzhz_8287/
指甲-髌骨综合征	zj_bgzhz/
指节垫	zjd/
致肠细胞病变人孤儿病毒感染	zcxbbbrgebdgr/
致密性骨发育障碍	zmxgfyza/
致心律失常性右室心肌病	zxlscxysxjb/
痔	z/
中毒性白内障	zdxbnz/
中毒性高铁血红蛋白血症	zdxgtxhdbxz/
中毒性红斑	zdxhb/
中青年脑梗死	zqnngs/
中枢神经系统白血病	zssjxtbxb/
中枢神经系统肉芽肿性血管炎	zssjxtryzxxgy/
中枢神经细胞瘤	zssjxbl/
中性粒细胞增多症	zxlxbzdz/
中央晕轮状脉络膜萎缩	zyylzmlmws/
中叶综合征	zyzhz/
种痘并发症	zdbfz/
重链病	zlb/
重症联合免疫缺陷	zzlhmyqx/
重症院内获得性肺炎	zzynhdxfy/
舟骨骨折	zggz_8308/
肘内翻畸形	znfjx/
珠蛋白生成障碍性贫血	zdbsczaxpx/
珠蛋白生成障碍性贫血视网膜病变	zdbsczaxpxswmbb/
猪带绦虫病	zdtcb/
主动脉弓综合征视网膜病变	zdmgzhzswmbb/
转换性障碍	zhxza/
转移性肝癌	zyxga/
转移性骨肿瘤	zyxgzl/
转移性皮肤钙化病	zyxpfghb/
转移性小肠肿瘤	zyxxczl/
椎动脉型颈椎病	zdmxjzb/
椎管内结核瘤	zgnjhl/
椎管内转移性肿瘤	zgnzyxzl/
椎间盘钙化症	zjpghz/
椎间隙感染	zjxgr/
椎体爆裂骨折	ztblgz/
椎体严重楔形变并伴小关节半脱位	ztyzxxbbbxgjbtw/
锥虫病	zcb/
着色性干皮病	zsxgpb/
着色芽生菌病	zsysjb/
子宫恶性中胚叶混合瘤	zgexzpyhhl/
子宫颈平滑肌瘤	zgjphjl/
子宫颈肉瘤	zgjrl/
子宫内翻	zgnf/
子宫内膜结核	zgnmjh/
子宫内膜息肉	zgnmxr/
子宫内膜异位	zgnmyw/
子宫平滑肌肉瘤	zgphjrl/
紫癜性扁平苔藓	zdxbptx/
自发性脑室内出血	zfxnsncx/
自发性气胸	zfxqx/
自律性房性心动过速	zlxfxxdgs/
自然流产	zrlc/
自身红细胞过敏性紫癜	zshxbgmxzd/
自身免疫性甲状腺疾病相关肾病	zsmyxjzxjbxgsb/
自身免疫性胰腺炎	zsmyxyxy/
自身免疫性孕酮性皮炎	zsmyxytxpy/
自体敏感性湿疹	ztmgxsz/
纵隔非霍奇金恶性淋巴肿瘤	zgfhqjexlbzl/
纵隔非霍奇金淋巴瘤	zgfhqjlbl/
纵隔副神经节起源的肿瘤	zgfsjjqydzl/
纵隔霍奇金淋巴瘤	zghqjlbl/
纵隔畸胎瘤	zgjtl/
纵隔间叶源性肿瘤及其他肿瘤	zgjyyxzljqtzl/
纵隔囊肿	zgnz_8353/
纵隔囊肿及肿瘤	zgnzjzl/
纵隔疝	zgs_8355/
纵隔神经鞘源性肿瘤	zgsjqyxzl/
纵隔肿瘤	zgzl/
足穿通性损害	zctxsh/
足跟瘀斑	zgyb/
组织细胞吞噬性脂膜炎	zzxbtsxzmy/
组织细胞纤维瘤	zzxbxwl/
左后分支传导阻滞	zhfzcdzz/
左前分支传导阻滞	zqfzcdzz/
左束支传导阻滞	zszcdzz/
左束支中隔支传导阻滞	zszzgzcdzz/
左心室恶性施万瘤	zxsexswl/
坐骨神经盆腔出口狭窄症	zgsjpqckxzz/
坐骨神经损伤	zgsjss/
Alagille综合征	alagillezhz/
肩周炎	jzy/
白睛溢血	bjyx/
白痢	bl/
白膜侵睛	bmqj/
白秃疮	btc/
白屑风	bxf/
白淫	by/
胞痹	bb/
胞生痰核	bsth/
暴痢	bl_8388/
暴泻	bx_8389/
背痈	by_8390/
奔豚气	btq/
崩漏	bl_8392/
鼻疔	bd/
鼻鼽	bq/
闭经性头痛	bjxtt/
痹证	bz/
玻璃体疝	blts/
蚕豆病	cdb/
产后喘促	chcc/
产后风	chf/
产后痉症	chjz/
产后劳伤	chls/
产后目病	chmb/
产后三冲	chsc/
产后三急	chsj/
产后伤食	chss/
产后虚羸	chxl/
产后血虚热	chxxr/
产后血瘀	chxy/
产褥中暑	crzs/
颤证	cz/
肠风	cf/
肠结	cj/
肠郁	cy/
常染色体隐性遗传性脑动脉病伴白质脑病	crstyxycxndmbbbznb/
潮热	cr/
赤白游风	cbyf/
赤痢	cl_8418/
赤脉传睛	cmcj/
赤脉贯布	cmgb/
赤膜下垂	cmxc/
赤丝虬脉	csqm/
赤游丹	cyd/
虫臌	cg/
虫积	cj_8425/
虫证	cz_8426/
喘证	cz_8427/
疮疡	cy_8428/
大肠湿热	dcsr/
大头瘟	dtw/
带下病	dxb/
丹痧	ds_8432/
胆咳	dk/
胆热	dr/
胆石	ds_8435/
胆胀	dz/
癫病	db/
癫狂病	dkb/
电脑病	dnb/
疔疮	dc_8440/
毒热侵肤	drqf/
顿呛	dq/
恶寒发热	ehfr/
儿童顿咳	etdk/
耳疮	ec/
耳疔	ed/
耳疖	ej/
耳痈	ey/
反社会人格障碍	fshrgza/
反射性神经障碍症	fsxsjzaz/
房事头疼症	fsttz/
飞扬喉	fyh/
肥疮	fc/
肥气	fq/
肺闭喘咳	fbck/
肺风粉刺	fffc/
肺咳	fk/
肺络张	flz/
肺气虚	fqx/
肺热咳嗽	frks/
肺功能衰竭	fgnsj/
肺衰	fs_8462/
肺痿	fw/
肺胀	fz_8464/
风痹	fb/
风寒犯肺	fhff/
风寒感冒	fhgm/
风寒头痛	fhtt/
风轮赤豆	flcd/
风轮湿热	flsr/
风秘	fm/
风牵偏视	fqps/
风热疮	frc/
风热犯肺	frff/
风热感冒	frgm/
风热头痛	frtt/
风搔痒	fsy_8477/
风温	fw_8478/
肤胀	fz_8479/
伏梁	fl_8480/
伏暑	fs_8481/
妇女咳嗽性遗尿	fnksxyn/
复发性多软骨炎性	ffxdrgyx/
干槽症	gcz/
干血痨	gxl_8485/
肝胆湿热	gdsr/
肝风内动证	gfndz/
肝火犯肺	ghff/
肝火上炎证	ghsyz/
肝火眩晕	ghxy/
肝厥	gj/
肝咳	gk/
肝热病	grb/
肝胃不和	gwbh/
肝瘟	gw/
肝血虚证	gxxz/
肝炎	gy_8497/
肝阳上亢	gysk/
肝著	gz_8499/
肛廔	gl_8500/
骨膜炎	gmy_8501/
骨蒸	gz_8502/
鼓胀	gz_8503/
瓜藤缠	gtc/
关格	gg/
假性动脉瘤	jxdml/
腘动脉损伤	gdmss_8507/
腘肌肌腱炎	gjjjy/
腘动脉陷迫综合征	gdmxpzhz/
过敏性眼睑皮肤炎	gmxyjpfy/
脊疳	jg/
寒痹	hb_8512/
寒湿困脾	hskp/
寒湿泄泻	hsxx/
寒饮咳嗽	hyks/
寒滞肝脉证	hzgmz/
汗证	hz_8517/
红蝴蝶疮	hhdc/
喉痹	hb_8519/
喉疮	hc/
喉喑	hy/
喉痈	hy_8522/
狐惑	hh/
花柳病	hlb/
花翳自陷	hyzx/
滑膜炎、痤疮、脓疱病、骨肥厚、骨髓炎综合	hmy_cc_npb_gfh_gsyzh/
化脓性角膜炎	hnxjmy/
环跳疽	htj/
黄水疮	hsc/
黄体功能不全性不孕	htgnbqxby/
回乳	hr/
哕	h/
混合痔	hhz/
混睛帐	hjz/
火眼	hy_8535/
积聚	jj_8536/
积滞	jz/
急喉风	jhf/
急黄	jh/
急淋	jl_8540/
棘间韧带损伤	jjrdss/
棘突骨折	jtgz/
棘突滑囊炎	jthny/
棘突压痛	jtyt/
脊髓灰质炎后遗症	jshzyhyz/
脊椎骨质增生	jzgzzs/
脊椎外伤	jzws/
夹色伤寒	jssh/
夹阴伤寒	jysh/
间质膀胱炎局限外阴炎和脱屑性阴道炎综合征	jzbgyjxwyyhtxxydyzhz/
煎厥	jj_8551/
睑板腺囊肿	jbxnz/
第1跖趾骨关节炎	d1zzggjy/
交肠	jc_8554/
椒疮	jc_8555/
角膜葡萄肿	jmptz/
节育手术并发症	jyssbfz/
口腔结核性溃疡	kqjhxky/
结胸证	jxz_8559/
金疮	jc_8560/
筋痹	jb_8561/
筋骨懈堕	jgxd/
筋瘤	jl_8563/
筋痿	jw/
进行性脊肌萎缩症	jxxjjwsz/
浸淫疮	jyc/
噤口痢	jkl/
经行发热	jxfr/
经行流涎	jxlx/
经行尿感	jxng/
经行舌麻	jxsm/
经行头痛	jxtt/
经行泄水	jxxs/
惊风	jf/
精瘀证	jyz/
精子增多症	jzzdz/
痉病	jb_8577/
久疟	jn/
久泄	jx_8579/
酒胀	jz_8580/
聚星障	jxz_8581/
厥脱	jt/
厥阴头痛	jytt/
厥证	jz_8584/
皲裂疮	jlc/
考后综合症	khzhz/
客忤	kw/
口糜	km/
口腔粘膜病	kqzmb/
口腔粘膜黑棘皮病	kqzmhjpb/
口周湿疹	kzsz/
苦夏	kx_8592/
狂病	kb/
痨瘵	lz_8594/
老年人原发性恶性高血压引起的恶性小动脉肾	lnryfxexgxyyqdexxdms/
雷头风	ltf/
肋间神经痛	ljsjt/
离位皮炎	lwpy/
黧黑斑	lhb_8599/
臁疮	lc_8600/
凉燥	lz_8601/
皮下裂头蚴病	pxltyb/
淋证	lz_8603/
流痰	lt/
流注	lz_8605/
六瘤	ll/
癃闭	lb_8607/
偻附	lf/
颅脑先天畸形	lnxtjx/
挛痹	lb_8610/
瘰疬	ll_8611/
马牙	my_8612/
蚂蚁叮咬	mydy/
脉痹	mb/
脉痿	mw/
脉溢	my_8616/
慢惊风	mjf/
慢脾风	mpf/
慢性肝炎	mxgy/
慢性咳嗽	mxks/
慢性疲劳综合症	mxplzhz/
猫眼疮	myc/
瞀瘛	mc/
梅核气	mhq/
猛兽伤	mss/
面游风	myf/
明癣	mx/
目病	mb_8628/
内热	nr/
内伤发热	nsfr/
奶麻	nm/
男科外伤	nkws/
囊痈	ny/
脑胶质瘤	njzl/
脑痨	nl_8635/
脑鸣	nm_8636/
脑萎	nw/
尿毒症昏迷	ndzhm/
尿精	nj_8639/
颞骨和下颔骨关节异常	nghxhggjyc/
脓包疮	nbc/
脓窠疮	nkc/
胬肉攀睛	nrpj/
女劳疸	nld/
女子梦交	nzmj/
Pasini-Pierni进行性皮肤萎缩	pasini_piernijxxpfws/
膀胱咳	bgk/
膀胱气痛	bgqt/
盆腔炎症性不孕症	pqyzxbyz/
皮痹	pb/
皮肤病	pfb/
脾疳	pg/
脾劳	pl/
脾水	ps_8654/
脾虚泄泻	pxxx/
脾约	py/
痞满	pm/
痞气	pq/
睥翻粘睑	pfzj/
偏沮	pj_8660/
干呕	go/
功能失调性子宫出血病	gnsdxzgcxb/
漆疮	qc_8663/
气腹痛	qft/
气臌	qg/
气痢	ql/
气瘤	ql_8667/
气秘	qm/
气疝	qs_8669/
气虚眩晕	qxxy/
气瘿	qy_8671/
气胀	qz/
憩室病	qsb/
千日疮	qrc/
嵌顿包茎	qdbj/
情感性交叉擦腿症	qgxjcctz/
秋燥	qz_8677/
癔病性昏厥	ybxhj/
热痹	rb/
热毒冲心	rdcx/
热汗	rh/
热咳	rk/
热秘	rm/
热入血室	rrxs/
热伤风	rsf/
热射病	rsb/
热哮	rx/
热中	rz_8688/
妊娠恶阻	rsez/
妊娠热病	rsrb/
肉痹	rb_8691/
肉痉	rj/
肉瘿	ry_8693/
乳发	rf/
乳痨	rl_8695/
乳疬	rl_8696/
乳泣	rq/
乳痈	ry_8698/
蓐劳	rl_8699/
三痹	sb_8700/
三焦咳	sjk/
色厥色脱	sjst/
色素斑	ssb/
色欲伤	sys/
痧气	sq_8705/
痧子	sz_8706/
伤风	sf/
伤食泄泻	ssxx/
少腹如扇	sfrs/
神昏	sh_8710/
神思间病	ssjb/
肾疳	sg_8712/
肾精亏虚	sjkx/
肾咳	sk/
肾气不固	sqbg/
肾虚耳鸣	sxem/
肾虚眩晕	sxxy/
肾虚腰痛	sxyt/
肾痈	sy_8719/
升主动脉瘤	szdml/
尸厥	sj/
失荣	sr/
湿痹	sb_8723/
湿毒疮	sdc/
湿热病	srb/
湿热痢	srl/
湿热蕴脾	sryp/
湿阻	sz_8728/
石油、煤焦油及其分馏产物所致的皮肤病	sy_mjyjqflcwszdpfb/
实喘	sc/
食管痹	sgb/
食积胃病	sjwb/
食瘕	sj_8733/
食滞胃脘主证	szwwzz/
视网膜脱落	swmtl_8735/
视瞻昏渺	szhm/
兽咬伤	sys_8737/
输卵管积水	slgjs/
输卵管结扎术后并发症	slgjzshbfz/
输卵管阻塞性不孕	slgzsxby/
暑湿	ss_8741/
暑瘵	sz_8742/
鼠咬伤	sys_8743/
水臌	sg_8744/
水疥	sj_8745/
水疝	ss_8746/
水肿	sz_8747/
水渍疮	szc/
四肢不用	szby/
宿醉	sz_8750/
粟疮	sc_8751/
锁喉毒	shd/
锁喉痈	shy/
胎赤	tc/
胎毒	td/
胎肥	tf_8756/
胎漏	tl/
胎盘部分残留	tpbfcl/
胎热	tr/
胎死不下	tsbx/
胎萎不长	twbc/
太阳病	tyb/
太阳中风	tyzf/
痰毒	td_8764/
痰火	th_8765/
痰火扰心	thrx/
痰积	tj_8767/
痰厥	tj_8768/
痰热咳嗽	trks/
痰湿阻肺	tszf/
痰饮	ty/
痰浊头痛	tztt/
痰浊眩晕	tzxy/
体质性低血压	tzxdxy/
天疤疮	tbc/
天柱倒	tzd_8776/
聤耳	te/
头风病	tfb/
吐失	ts_8779/
团癣	tx_8780/
退行性黄韧带肥厚	txxhrdfh/
脱疽	tj_8782/
脱囊	tn/
脱阳	ty_8784/
啘	w/
顽痹	wb_8786/
往来寒热	wlhr/
维生素Ａ缺乏症所致的角膜溃疡病	wss_qfzszdjmkyb/
痿病	wb_8789/
痿证	wz_8790/
胃肠积液	wcjy/
胃寒呕吐	whot/
胃纳呆滞	wndz/
温虐	wn/
温热	wr/
蚊子叮咬	wzdy/
无排卵性不孕症	wplxbyz/
五迟	wc/
五更泄	wgx/
五积	wj/
五软	wr_8801/
五硬	wy/
五脏痹	wzb/
吸烟中毒症	xyzdz/
息贲	xb/
息积	xj_8806/
膝关节骨性关节炎	xgjgxgjy/
下消	xx_8808/
夏季低热	xjdr/
夏季热	xjr/
先天性白细胞颗粒异常综合征	xtxbxbklyczhz/
先天性心脏病	xtxxzb/
项痹	xb_8813/
消中	xz/
小肠气痛	xcqt/
小肠实热	xcsr/
小肠虚寒	xcxh/
小儿46-XY单纯性腺发育不全综合征	xe46_xydcxxfybqzhz/
小儿疳渴	xegk/
小儿疳痢	xegl/
小儿疳眼	xegy/
小儿发烧	xefs/
小儿格林巴利综合症	xeglblzhz/
小儿黄水疮	xehsc/
小儿流涎症	xelxz/
小儿脓窠疮	xenkc/
小儿盘肠气痛	xepcqt/
小儿热疮	xerc/
小儿乳积	xerj/
小儿肾母细胞瘤	xesmxbl_8830/
小儿食积	xesj/
小儿暑温	xesw/
小儿头疖	xetj/
小儿维生素B1缺乏病	xewssb1qfb/
小儿维生素B2缺乏病	xewssb2qfb/
小儿维生素B6缺乏病	xewssb6qfb/
小儿泄泻	xexx/
小儿眼外肌麻痹-视网膜色素变性-心脏传导	xeywjmb_swmssbx_xzcd/
哮病	xb_8839/
胁痛	xt/
蟹睛	xj_8841/
心瘅	xd/
心火上炎	xhsy/
心厥	xj_8844/
心脾两虚	xplx/
心气虚	xqx/
心肾不交	xsbj/
猝死	cs/
心血虚	xxx/
心血瘀阻	xxyz/
心阳虚	xyx/
心阴虚	xyx_8852/
行经泄泻	xjxx/
性交晕厥	xjyj/
胸痹	xb_8855/
胸痹心痛	xbxt/
休息痢	xxl_8857/
虚喘	xc_8858/
虚寒咳嗽	xhks/
虚寒呕吐	xhot/
虚寒泄泻	xhxx/
虚劳	xl_8862/
虚疟	xn_8863/
痃癖	xp/
血痹	xb_8865/
血疸	xd_8866/
血风疮	xfc/
血灌瞳神	xgts/
血厥	xj_8869/
血劳	xl_8870/
血瘤	xl_8871/
血气胸	xqx_8872/
血清抗精子抗体阳性之不孕症	xqkjzktyxzbyz/
血热崩漏	xrbl/
血虚头痛	xxtt/
血虚眩晕	xxxy/
血证	xz_8877/
狐臭	hc_8878/
脑膜转移瘤	nmzyl/
牙宣	yx_8880/
牙痈	yy/
眼丹	yd_8882/
眼睑丹毒	yjdd/
眼睑疖肿和脓肿	yjjzhnz/
眼睑热性疱疹	yjrxpz/
眼睑炭疽	yjtj/
羊胡疮	yhc/
阳明头痛	ymtt/
阳强	yq/
阳虚	yx_8890/
阳虚发热	yxfr/
杨梅疮	ymc/
腰椎间盘突出	yzjptc/
噎膈	yg_8894/
液脱	yt/
噫气	yq_8896/
胰痈	yy_8897/
遗传过敏性皮炎	ycgmxpy/
疫斑热	ybr/
疫毒痢	ydl/
疫黄	yh/
溢饮	yy_8902/
阴痹	yb/
阴疮	yc_8904/
阴吹	yc_8905/
阴道壁脱垂	ydbtc/
阴汗	yh_8907/
阴结	yj_8908/
阴茎痰核	yjth/
阴冷	yl_8910/
阴盛阳衰症	ysysz/
阴缩	ys_8912/
阴挺	yt_8913/
阴虚发热	yxfr_8914/
阴虚火旺	yxhw/
婴儿闷热综合症	yemrzhz/
婴儿型黑矇性痴呆	yexhmxcd/
婴幼儿舌下囊肿	yyesxnz/
营养缺乏性神经病变	yyqfxsjbb/
有头疽	ytj/
瘀血头痛	yxtt/
瘀证	yz_8922/
郁冒	ym/
郁证	yz_8924/
圆翳内障	yynz/
月经失调性不孕症	yjsdxbyz/
月劳病	ylb_8927/
脏寒	zh/
脏躁	zz/
燥邪犯肺	zxff/
瘴疟	zn/
振栗	zl/
怔忡	zc_8933/
症瘕	zj/
肢萎	zw_8935/
蜘蛛咬伤	zzys/
指疔	zd/
中风后遗症	zfhyz/
中满	zm/
中气不足	zqbz/
肿胀	zz_8941/
重舌	zs_8942/
重瞳	zt_8943/
周期性四肢运动障碍	zqxszydza/
周围神经炎	zwsjy/
疰夏	zx_8946/
著痹	zb_8947/
壮热	zr/
子烦	zf_8949/
子满	zm_8950/
子嗽	zs_8951/
子痰	zt_8952/
子痫	zx_8953/
子悬	zx_8954/
子喑	zy_8955/
走哺	zb_8956/
走黄	zh_8957/
坐板疮	zbc/
垂痈	cy_8959/
唇风	cf_8960/
唇疱疹	cpz/
抗-HCVAg阳性	k_hcvagyx/
老烂腿	llt/
脑萎缩	nws/
扁桃体炎	btty/
胰腺炎	yxy/
鼻炎	by_8977/
慢性结肠炎	mxjcy/
肠炎	cy_8979/
溃疡性肠炎	kyxcy/
缺血性肠炎	qxxcy/
细菌性肠炎	xjxcy/
直肠炎	zcy/
慢性肠炎	mxcy/
腰椎病	yzb_8985/
肠胃炎	cwy/
肾小球肾炎	sxqsy/
脊柱侧弯	jzcw/
肾炎	sy_8989/
卵巢炎	lcy/
手外伤	sws/
腱鞘炎	jqy/
椎管狭窄	zgxz/
心力衰竭	xlsj/
肺心病	fxb/
胆囊炎	dny/
输卵管炎	slgy/
韧带损伤	rdss/
病毒性肠炎	bdxcy/
关节炎	gjy/
静脉曲张	jmqz/
滑膜炎	hmy/
强直型脑瘫	qzxnt/
混合型脑瘫	hhxnt/
软组织损伤	rzzss/
多囊肝	dng/
肾功能衰竭	sgnsj/
心脏瓣膜病	xzbmb/
慢性肾功能不全	mxsgnbq/
风湿性心脏病	fsxxzb/
心脏病	xzb/
肌肉痉挛	jrjl/
脊髓炎	jsy_9013/
支气管炎	zqgy/
鲜红斑痣	xhbz/
蔓状血管瘤	mzxgl/
脉管畸形	mgjx/
甲状腺炎	jzxy/
甲亢眼突	jkyt/
甲状腺结节	jzxjj/
精神障碍	jsza/
食管炎	sgy/
视网膜炎	swmy/
肠癌	ca/
胃炎	wy_9025/
咽炎	yy_9026/
中耳炎	zey/
结膜炎	jmy_9028/
皮炎	py_9029/
生殖道感染	szdgr/
阴道炎	ydy/
弱精	rj_9032/
精子畸形	jzjx/
子宫内膜薄	zgnmb/
输卵管阻塞	slgzs/
黄体功能不全	htgnbq/
肌张力不全型脑瘫	jzlbqxnt/
手足徐动性脑瘫	szxdxnt/
共济失调型脑瘫	gjsdxnt/
假性尖锐湿疣	jxjrsy/
口腔尖锐湿疣	kqjrsy/
子宫癌	zga/
口腔血管瘤	kqxgl/
胆管肿瘤	dgzl/
乳腺脂肪瘤	rxzfl/
子宫内膜炎	zgnmy/
宫颈炎	gjy_9047/
皮肤白斑	pfbb/
乳腺肿瘤	rxzl/
乳腺炎	rxy/
急性肾功能不全	jxsgnbq/
肾功能不全	sgnbq/
霉菌性尿道炎	mjxndy/
淋菌性尿道炎	ljxndy/
浅表性胃炎	qbxwy/
脉管炎	mgy/
坏死性脉管炎	hsxmgy/
性功能障碍	xgnza_9058/
血精症	xjz_9059/
细菌性前列腺炎	xjxqlxy/
急性细菌性前列腺炎	jxxjxqlxy/
非淋性前列腺炎	flxqlxy/
特异性前列腺炎	tyxqlxy/
精神病	jsb/
药物性哮喘	ywxxc/
念珠龟头炎	nzgty/
疱疹	pz_9067/
混合血管瘤	hhxgl/
毛细血管瘤	mxxgl/
化脓性乳腺炎	hnxrxy/
乳腺导管瘤	rxdgl/
牙周炎	yzy/
角膜炎	jmy_9073/
结肠炎	jcy/
斜视	xs/
唇炎	cy_9076/
牙龈炎	yyy/
喉炎	hy_9078/
睾丸癌	gwa/
肝癌	ga/
胸膜炎	xmy/
阑尾炎	lwy/
肾虚	sx_9083/
心内膜炎	xnmy/
血管炎	xgy/
胃穿孔	wck/
慢性糜烂性胃炎	mxmlxwy/
慢性乳突炎	mxrty/
上呼吸道感染	shxdgr/
Usher综合征	usherzhz/
结膜充血	jmcx/
慢性乳腺炎	mxrxy/
心理障碍	xlza/
矮小症	axz/
社交恐惧症	sjkjz/
急性胆管炎	jxdgy/
糜烂性胃炎	mlxwy/
瘢痕性睑内翻	bhxjnf/
神经性头痛	sjxtt/
办公室综合症	bgszhz/
肾绞痛	sjt/
泌尿系结石	mnxjs/
心血管疾病	xxgjb/
肾脓肿	snz_9104/
包涵体肌炎	bhtjy/
鼻部囊肿	bbnz/
乳腺囊肿	rxnz/
肾性脑病	sxnb/
鼻外伤	bws/
胸椎	xz_9110/
耳鸣	em/
肺纤维化	fxwh/
脑水肿	nsz/
闭合性颅脑损伤	bhxlnss/
排卵障碍	plza/
偏瘫	pt/
扁桃体结石	bttjs/
肾阳虚	syx_9118/
脑外伤	nws_9119/
变异性哮喘	byxxc/
肾阴虚	syx_9121/
脑血管畸形	nxgjx/
肾肿瘤	szl/
并指畸形	bzjx/
渗出性中耳炎	scxzey/
急性肺水肿	jxfsz/
急性根尖牙周炎	jxgjyzy/
失眠抑郁	smyy/
慢性根尖牙周炎	mxgjyzy/
食道溃疡	sdky/
脑干梗塞	nggs/
急性冠脉综合征	jxgmzhz/
病毒性结膜炎	bdxjmy/
视网膜分支动脉阻塞	swmfzdmzs/
牙髓炎	ysy_9135/
手足综合症	szzhz/
急性牙髓炎	jxysy/
慢性牙髓炎	mxysy/
脊柱畸形	jzjx_9139/
睑缘炎	jyy/
结核性盆腔炎	jhxpqy/
内分泌性高血压	nfmxgxy/
酒精性股骨头坏死	jjxggths/
病毒性上呼吸道感染	bdxshxdgr/
输卵管畸形	slgjx/
慢性外耳道炎	mxwedy/
酒精性脂肪肝	jjxzfg/
开放性颅脑损伤	kfxlnss/
病毒性胃肠炎	bdxwcy/
慢性中耳炎	mxzey/
空巢综合症	kczhz/
老年性睑外翻	lnxjwf/
不孕不育	byby/
老年性哮喘	lnxxc/
输卵管妊娠流产	slgrslc/
慢性细菌性痢疾	mxxjxlj/
草莓状血管瘤	cmzxgl/
肠痉挛	cjl/
乳突炎	rty/
抽动症	cdz/
青春前期牙周炎	qcqqyzy/
复张性肺水肿	fzxfsz/
出血性脑中风	cxxnzf/
青春期厌食症	qcqysz/
腹外疝	fws/
唇癌	ca_9166/
钙化性肌腱炎	ghxjjy/
色斑	sb_9168/
色素性痒疹	ssxyz/
大脑萎缩	dnws/
肛肠息肉	gcxr/
慢性牙周炎	mxyzy/
胆管结石	dgjs/
肛门异物感	gmywg/
胆管炎	dgy/
高位截瘫	gwjt/
脓毒症	ndz_9177/
屏幕脸	pml/
高血压性心脏病	gxyxxzb/
低钙血症	dgxz/
高血压眼病	gxyyb/
膀胱膨出	bgpc/
高原病	gyb/
低颅压综合征	dlyzhz/
疲劳性骨折	plxgz/
睾丸畸形	gwjx/
青少年癫痫	qsndx/
睾丸鞘膜积液	gwqmjy/
寻常型天疱疮	xcxtpc/
电解质紊乱	djzwl/
根尖脓肿	gjnz/
免疫性不孕	myxby/
宫角妊娠	gjrs_9193/
牙斑	yb_9194/
蝶窦炎	ddy/
尿潴留	nzl/
空调病	kdb/
口炎	ky/
脓疱型银屑病	npxyxb/
动脉栓塞	dmss/
肋软骨炎	lrgy/
风湿病	fsb_9202/
颅裂	ll_9203/
女性假两性畸形	nxjlxjx/
多动症	ddz/
牙周脓肿	yznz/
颅脑损伤	lnss/
功能性胃肠病	gnxwcb/
颅内出血	lncx/
女性癫痫	nxdx/
儿童股骨头坏死	etggths/
睾丸囊肿	gwnz_9212/
卵巢囊肿蒂扭转	lcnzdnz/
睑内翻	jnf/
卵巢性不孕	lcxby/
小儿支气管炎	xezqgy/
麻痹性睑外翻	mbxjwf/
耳结核	ejh/
慢性粒单核细胞白血病	mxldhxbbxb/
膝内翻	xnf/
骨癌	ga_9221/
返流性胆管炎	flxdgy/
马蹄形肾	mtxs/
眼底出血	ydcx/
放射性口炎	fsxky/
输卵管性不孕	slgxby/
骨坏死	ghs/
淋巴炎	lby/
骨结核	gjh_9229/
非特异性外阴炎	ftyxwyy/
输卵管妊娠破裂	slgrspl/
截瘫	jt_9232/
骨筋膜室综合症	gjmszhz/
眼外伤	yws_9234/
脊椎炎	jzy_9235/
输卵管肿瘤	slgzl/
急性中耳炎	jxzey/
冠状动脉供血不足	gzdmgxbz/
表皮样囊肿	bpynz/
过敏性结肠炎	gmxjcy/
外伤性股骨头坏死	wsxggths/
心肌缺血	xjqx/
输血后肝炎	sxhgy/
红皮性银屑病	hpxyxb/
心包炎	xby/
喉痉挛	hjl/
药物过敏性口炎	ywgmxky/
药物性耳聋	ywxel/
药物中毒	ywzd/
喉麻痹	hmb/
胰头癌	yta/
糖尿病型牙周炎	tnbxyzy/
喉水肿	hsz/
小细胞肺癌	xxbfa/
胰腺结核	yxjh/
臀肌挛缩症	tjlsz/
遗传性肾炎	ycxsy/
小儿肠炎	xecy/
原发性脑干损伤	yfxngss/
喉狭窄	hxz/
躁狂抑郁症	zkyyz/
真菌性脑膜炎	zjxnmy/
网络成瘾	wlcy/
化脓性鼻窦炎	hnxbdy/
支气管结石症	zqgjsz/
消化道溃疡	xhdky/
侏儒症	zrz/
胃窦炎	wdy/
化脓性腮腺炎	hnxsxy/
无脑儿	wne/
消化不良	xhbl/
化脓性中耳炎	hnxzey/
子宫性不孕	zgxby/
坏死性外耳道炎	hsxwedy/
习惯性便秘	xgxbm/
紫癜	zd_9276/
小脑萎缩	xnws/
细菌性脑膜炎	xjxnmy/
习惯性流产	xgxlc/
肝硬化腹水	gyhfs/
胃痉挛	wjl/
会厌囊肿	hynz/
激素性股骨头坏死	jsxggths/
会厌炎	hyy/
肌肉萎缩	jrws/
宫腔粘连	gqzl/
白带异常	bdyc_9287/
痛风石	tfs/
宫颈肥大	gjfd/
乳房疼痛	rftt/
乳房肿块	rfzk/
肛门尖锐湿疣	gmjrsy/
甲状腺血管瘤	jzxxgl/
淤胆型肝炎	ydxgy/
大隐静脉曲张	dyjmqz/
复发性阿弗他溃疡	ffxaftky/
膝关节韧带损伤	xgjrdss/
腰椎骨折	yzgz/
胸腰椎骨折	xyzgz/
子宫内膜厚	zgnmh/
眼底病	ydb_9301/
胚胎停育	ptty/
输卵管粘连	slgzl_9303/
内分泌失调	nfmsd/
放射性颌骨骨髓炎	fsxhggsy/
骨不连	gbl/
H7N9型禽流感	h7n9xqlg/
卵泡发育不良	lpfybl/
巧克力囊肿	qklnz/
宫寒	gh/
盆腔积液	pqjy/
输卵管上举	slgsj/
包皮水肿	bpsz/
子宫积液	zgjy/
阴囊潮湿	yncs/
急性尿道炎	jxndy/
小儿咳嗽	xeks/
阴囊炎	yny_9318/
滴虫性尿道炎	dcxndy/
精液不液化	jybyh/
急性浅表性包皮龟头炎	jxqbxbpgty/
体寒	th_9322/
子宫内膜不规则脱落	zgnmbgztl/
月经量少	yjls_9324/
包皮炎	bpy_9325/
早秃	zt_9326/
儿童尖锐湿疣	etjrsy/
女性尖锐湿疣	nxjrsy/
男性尖锐湿疣	nxjrsy_9329/
错构瘤	cgl/
多肌炎	djy/
多瓣膜病	dbmb/
髌骨脱位	bgtw/
病毒性睑皮炎	bdxjpy/
多器官功能障碍综合征	dqggnzazhz/
玻璃体病	bltb/
代谢综合征	dxzhz/
玻璃体寄生虫病	bltjscb/
Pick病和额颞痴呆	pickbhencd/
Rotor综合征	rotorzhz/
白化病	bhb/
白细胞减少症	bxbjsz/
单纯性紫癜	dcxzd/
玻璃体液化	bltyh/
侧颅底肿瘤	cldzl/
产后风湿	chfs/
不完全性肠梗阻	bwqxcgz/
肠粘连	czl/
儿童分离性焦虑障碍	etflxjlza/
肠系膜血管缺血性疾病	cxmxgqxxjb/
膝外翻	xwf/
儿童焦虑症	etjlz/
尺神经麻痹	csjmb/
儿童恐惧症	etkjz/
出血性脑卒中	cxxnzz/
疤痕	bh_9356/
胆道感染	ddgr/
传导性耳聋	cdxel/
儿童社交恐惧症	etsjkjz/
斑疹伤寒	bzsh/
耳廓假囊肿	ekjnz/
鼻部脑膜脑膨出	bbnmnpc/
创伤性耳聋	csxel/
耳廓外伤	ekws/
膀胱湿热	bgsr/
椎-基底动脉盗血综合征	z_jddmdxzhz/
胆道结石	ddjs/
耳外伤	ews_9368/
椎体骨软骨病	ztgrgb/
耳硬化症	eyhz/
鼻窦粘膜囊肿	bdzmnz/
唇腭裂	cel/
发育迟缓	fych/
鼻窦粘液囊肿	bdzynz/
飞蚊症	fwz/
法洛三联症	flslz_9376/
肺动脉瓣关闭不全	fdmbgbbq/
反流性肾病	flxsb/
肺动脉闭锁	fdmbs/
反射性晕厥	fsxyj/
肺静脉异位引流	fjmywyl/
房事两感症	fslgz/
鼻前颅底肿瘤	bqldzl/
鼻骨瘤	bgl_9384/
房室交界区性逸搏	fsjjqxyb/
淋巴管平滑肌瘤	lbgphjl/
胆道肿瘤	ddzl/
鼻源性头痛	byxtt/
粉碎性骨折	fsxgz/
胆道癌	dda/
风湿性疾病	fsxjb/
鼻中隔血肿及脓肿	bzgxzjnz/
非器质性冷阴	fqzxly/
腹股沟疝	fggs/
鼻肿瘤	bzl/
胆管炎性狭窄	dgyxxz/
非器质性性乐高潮障碍	fqzxxlgcza/
腹膜肿瘤	fmzl/
小儿鼻炎	xeby/
肝病	gb/
非器质性性欲减退	fqzxxyjt/
肝破裂	gpl/
高甘油三酯血症	ggyszxz/
胆脂瘤型中耳炎	dzlxzey/
过敏性结膜炎	gmxjmy/
泌尿生殖系损伤	mnszxss/
高胰岛素血症	gydsxz/
胆总管囊肿	dzgnz/
过敏性皮炎	gmxpy/
闭锁综合征	bszhz_9410/
咳嗽	ks/
扁桃体癌	btta/
跟腱断裂	gjdl/
颈部水囊瘤	jbsnl/
红斑型天疱疮	hbxtpc/
颈动脉盗血综合征	jdmdxzhz/
虹膜囊肿	hmnz/
黄斑前膜	hbqm/
颈肩痛	jjt/
虹膜炎	hmy_9420/
蛋白尿	dbn/
颈内动脉海绵窦瘘	jndmhmdl/
喉插管损伤	hcgss/
肌腱炎	jjy/
喉刺伤	hcs/
倒睫	dj_9426/
肌纤维组织炎	jxwzzy/
功能性聋	gnxl/
喉淀粉样变	hdfyb/
宫颈癌前病变	gjaqbb/
宫颈湿疣	gjsy/
低血容量性休克	dxrlxxk/
骶管囊肿	dgnz/
肌强直性肌病	jqzxjb/
股神经痛	gsjt/
喉火器伤	hhqs/
股外侧皮神经病	gwcpsjb/
原发性膀胱输尿管返流	yfxbgsngfl/
喉角化症	hjhz/
骨裂	gl_9440/
喉结核	hjh/
骨缺损	gqs/
急腹症	jfz/
骨软骨病	grgb/
动脉粥样硬化	dmzyyh/
急性肠炎	jxcy/
喉粘液囊肿	hzynz/
骨髓增生性疾病	gszsxjb/
急性根尖周炎	jxgjzy/
骨损伤	gss_9450/
喉纤维瘤	hxwl/
关节扭伤	gjns/
急性脑血管病	jxnxgb/
喉切伤	hqs/
关节痛	gjt/
急性上呼吸道感染	jxshxdgr/
喉乳头状瘤	hrtzl/
过劳死	gls/
喉烧灼伤	hszs/
毒虫螫咬伤	dcsys/
喉烫伤	hts/
精原细胞瘤	jyxbl/
喉外伤	hws/
脊椎病	jzb_9464/
脊髓出血性疾病	jscxxjb/
进食障碍	jsza_9466/
喉血管瘤	hxgl/
脊髓梗死	jsgs/
喉异物	hyw/
酒精性肝炎	jjxgy/
泪腺囊样腺癌	lxnyxa/
酒精性肝硬化	jjxgyh/
喉肿瘤	hzl/
脊髓缺血性疾病	jsqxxjb/
泪腺肿瘤	lxzl/
酒精中毒性精神障碍	jjzdxjsza/
巨脑回畸形	jnhjx/
脊髓损伤	jsss/
脊髓小脑性共济失调	jsxnxgjsd/
巨乳症	jrz_9480/
淋巴结核	lbjh/
呼吸道感染	hxdgr/
脊柱骨折	jzgz/
双行睫	sxj/
颅底肿瘤	ldzl/
脊柱结核	jzjh_9486/
踝部扭伤	hbns/
抗生素诱发的肠炎	kssyfdcy/
口腔颌面部间隙感染	kqhmbjxgr/
脊柱转移癌	jzzya/
寄生虫病	jscb/
口腔颌面部毛细管型淋巴管瘤	kqhmbmxgxlbgl/
黄斑变性	hbbx/
继发性高血压	jfxgxy/
黄斑病	hbb/
口腔颌面部囊肿	kqhmbnz/
念珠菌阴道炎	nzjydy/
黄斑裂孔	hblk/
口腔颌面部损伤	kqhmbss/
少突胶质细胞瘤	stjzxbl/
甲周炎	jzy_9501/
口腔颌面部血管瘤	kqhmbxgl/
三高症	sgz/
甲状旁腺功能亢进	jzpxgnkj/
口腔颌面部肿瘤	kqhmbzl/
环形胰腺	hxyx/
口腔炎	kqy/
侵蚀性葡萄胎	qsxptt/
间质性肺炎	jzxfy/
口咽良性肿瘤	kylxzl/
髋关节骨关节炎	kgjggjy/
僵汜	js_9512/
内眦赘皮	nzzp/
泪道阻塞	ldzs/
交感神经型颈椎病	jgsjxjzb/
乳头乳晕角化过度症	rtryjhgdz/
先天性肠狭窄	xtxcxz/
角化病	jhb/
颅内静脉窦血栓形成	lnjmdxsxc/
曲霉菌病	qmjb/
先天性耳前瘘管	xtxeqlg/
双主动脉弓	szdmg/
角膜溃疡	jmky/
外阴肿瘤	wyzl/
先天性冠状动脉瘤	xtxgzdml_9525/
睡眠-觉醒节律障碍	sm_jxjlza/
角膜老年环	jmlnh/
先天性喉软骨畸形	xtxhrgjx/
落叶型天疱疮	lyxtpc/
接触性睑皮炎	jcxjpy/
粟丘疹	sqz/
先天性睑裂狭小综合征	xtxjlxxzhz/
脓胸	nx_9533/
先天性小耳畸形	xtxxejx/
胎盘部位滋养细胞肿瘤	tpbwzyxbzl/
脉络膜缺损	mlmqs/
结核病	jhb_9537/
先天性眼睑缺损	xtxyjqs/
糖尿病坏疽	tnbhj/
结直肠癌	jzca/
全葡萄膜炎	qptmy_9541/
目劄病	mzb_9542/
先兆流产	xzlc/
完全性大动脉转位	wqxddmzw/
特异性心肌病	tyxxjb/
腺癌	xa/
体虱	ts_9547/
强直性肌营养不良症	qzxjyyblz/
桡骨头半脱位	rgtbtw/
腺样体炎	xyty/
头虱	ts_9551/
筋膜炎	jmy_9552/
颧骨颧弓骨折	qgqggz/
消渴病	xkb/
外耳道胆脂瘤	weddzl/
腕尺管综合征	wcgzhz/
脑动脉盗血综合征	ndmdxzhz/
小肠破裂	xcpl/
外耳道耵聍腺肿瘤	weddnxzl/
神经皮肤综合征	sjpfzhz/
缺血性脑卒中	qxxnzz/
前列腺钙化	qlxgh/
网瘾	wy_9563/
外耳道外生骨疣	wedwsgy/
脑脊液鼻漏	njybl/
神经性耳聋	sjxel/
微量元素障碍	wlysza/
热痉挛	rjl/
血管网状细胞瘤	xgwzxbl_9569/
外耳道肿瘤	wedzl/
疱疹性角膜炎	pzxjmy/
神经性耳鸣	sjxem/
小儿骨折	xegz/
小儿溃疡性口炎	xekyxky/
维生素A摄入过多	wssasrgd/
血脂异常	xzyc/
神经炎	sjy/
输卵管狭窄	slgxz/
胃十二指肠溃疡瘢痕性幽门梗阻	wsezckybhxymgz/
脑血管病	nxgb/
小儿麻疹	xemz/
热衰竭	rsj/
小儿风疹	xefz_9583/
胃肿瘤	wzl_9584/
亚健康	yjk/
脑血管痉挛	nxgjl/
维生素D缺乏性手足抽搐症	wssdqfxszccz/
输卵管囊肿	slgnz/
脑血管硬化	nxgyh/
无肌病性皮肌炎	wjbxpjy/
人禽流行性感冒	rqlxxgm/
肾上腺肿瘤	ssxzl/
咽部狭窄及闭锁	ybxzjbs/
疱疹样天疱疮	pzytpc/
小儿脑肿瘤	xenzl/
妊娠合并弓形虫病	rshbgxcb/
无泪症	wlz/
脑源性晕厥	nyxyj/
输卵管卵巢脓肿	slglcnz/
口唇疱疹	kcpz/
恶性骨肿瘤	exgzl/
咽麻痹	ymb/
小儿弱视	xers/
肾性骨病	sxgb/
眼睑闭合不全	yjbhbq/
小儿肾积水	xesjs/
恶性肿瘤	exzl/
维生素D中毒	wssdzd/
颞下颌关节病	nxhgjb/
小儿湿疹	xesz/
物理性皮肤病	wlxpfb/
眼眶脑膜瘤	yknml/
小儿大肠杆菌肠炎	xedcgjcy/
妊娠合并获得性免疫缺陷综合征	rshbhdxmyqxzhz/
伪聋	wl/
佩梅病	pmb/
手汗症	shz_9617/
头皮撕脱伤	tpsts/
腰椎滑脱	yzht/
膝关节滑膜皱襞综合征	xgjhmzbzhz/
未分化脊柱关节病	wfhjzgjb/
儿童腺样体肥大	etxytfd/
盆腔肿瘤	pqzl/
膝关节损伤	xgjss/
皮肤肿瘤	pfzl/
视网膜震荡	swmzd/
脊柱关节炎	jzgjy/
夜惊	yj_9628/
小儿斜视	xexs/
席汉氏综合症	xhszhz/
妊娠合并尖锐湿疣	rshbjrsy/
系膜毛细血管性肾小球肾炎	xmmxxgxsxqsy/
胃出血	wcx/
癔症性失声	yzxss/
噪声性聋	zsxl/
妊娠合并巨细胞病毒感染	rshbjxbbdgr/
系膜增生性肾小球肾炎	xmzsxsxqsy/
咽结合膜热	yjhmr/
视网膜裂孔	swmlk/
足部骨折	zbgz/
妊娠合并淋病	rshblb/
增殖型天疱疮	zzxtpc/
阻生齿	zsc/
妊娠合并梅毒	rshbmd/
小儿阵发性心动过速	xezfxxdgs/
阴道脱垂	ydtc/
细菌性皮肤病	xjxpfb/
妊娠合并沙眼衣原体感染	rshbsyyytgr/
下肢淋巴水肿	xzlbsz/
视神经撕脱	ssjst/
褶烂	zl_9651/
中毒性细菌性痢疾	zdxxjxlj/
声带小结	sdxj/
妊娠合并生殖道沙眼衣原体感染	rshbszdsyyytgr/
先天性并指多指畸形	xtxbzdzjx/
隐匿型冠状动脉粥样硬化性心脏病	ynxgzdmzyyhxxzb/
小儿中耳炎	xezey/
皮脂腺异位症	pzxywz/
子宫肉瘤	zgrl/
妊娠合并生殖器疱疹	rshbszqpz/
视神经疾病	ssjjb/
真菌性甲沟炎	zjxjgy/
婴幼儿化脓性淋巴结炎	yyehnxlbjy/
妊娠合并心脏病	rshbxzb/
自身免疫性肝病	zsmyxgb/
小角膜	xjm/
葡萄膜病	ptmb/
自身免疫性肝炎	zsmyxgy/
妊娠合并支原体感染	rshbzytgr/
自身敏感性皮炎	zsmgxpy/
心动过缓	xdgh/
妊娠期合并急性胆囊炎	rsqhbjxdny/
纵膈肿瘤	zgzl_9673/
先天性泌尿系畸形	xtxmnxjx/
真菌性皮肤病	zjxpfb/
室性心律失常	sxxlsc/
心内膜垫缺损	xnmdqs/
心脏损伤	xzss_9678/
下肢神经损伤	xzsjss/
营养性贫血	yyxpx/
主动脉口狭窄	zdmkxz/
生殖细胞瘤	szxbl/
妊娠纹	rsw/
主-肺动脉间隔缺损	z_fdmjgqs/
羌虫病	qcb/
日光角化病	rgjhb/
重复肾盂输尿管畸形	zfsysngjx/
颞下颌间挛缩	nxhjls/
失语症	syz_9689/
蛛网膜囊肿	zwmnz/
乳房肉瘤	rfrl/
食管狭窄	sgxz/
食管良性肿瘤	sglxzl/
粘多糖代谢障碍	zdtdxza/
骶髂关节炎	dqgjy/
拟除虫菊酯类杀虫药中毒	nccjzlscyzd/
脊髓半切综合征	jsbqzhz/
旋后肌综合征	xhjzhz/
新生儿臂丛神经麻痹	xsebcsjmb/
新生儿脐炎	xseqy/
新生儿锁骨骨折	xsesggz/
蛋白质-热能营养障碍	dbz_rnyyza/
胸膜间皮瘤	xmjpl/
小儿病毒性肺炎	xebdxfy/
支气管结核	zqgjh/
支气管腺瘤	zqgxl/
原发性侧索硬化	yfxcsyh/
小儿喉痉挛	xehjl/
成人先天性髋关节脱位	crxtxkgjtw/
烫伤	ts_9714/
整形添加属性1	zxtjsx1/
上线测试二三级	sxcsesj/
H7n7	h7n7/
老年病	lnb_9723/
眼病	yb_9724/
性病	xb_9725/
心理疾病	xljb/
男性病	nxb/
胸椎病	xzb_9728/
肠系膜淋巴结炎	cxmlbjy/
妇科疾病	fkjb/
血液病	xyb_9731/
裂纹舌	lws/
骨折不愈合	gzbyh/
肾萎缩	sws_9734/
胆囊息肉样病变	dnxrybb/
脑炎后遗症	nyhyz/
黑头粉刺痣	htfcz/
妇科炎症	fkyz/
肾病	sb_9739/
急慢性肝炎	jmxgy/
脑癌	na/
肛肠疾病	gcjb/
宫颈疾病	gjjb/
呼吸疾病	hxjb/
肺病	fb_9745/
泌尿感染	mngr/
乳腺病	rxb/
癌症	az/
牙科病	ykb/
男科病	nkb/
脑发育不良	nfybl/
妇科综合	fkzh/
口腔疾病	kqjb/
骨病	gb_9754/
妇科病	fkb/
肿瘤	zl_9756/
血管病	xgb/
内分泌病	nfmb/
脊柱疾病	jzjb_9759/
脑病	nb/
遗传病	ycb_9761/
甲状腺疾病	jzxjb/
牙病	yb_9763/
口腔病	kqb_9764/
关节疼痛	gjtt/
咽喉痛	yht/
盆腔疾病	pqjb/
乳腺疾病	rxjb/
支气管病	zqgb/
神经类疾病	sjljb/
耳病	eb/
食管病	sgb_9772/
月经病	yjb/
肛肠病	gcb_9774/
鼻病	bb_9775/
血压病	xyb_9776/
淋巴病	lbb/
细菌感染	xjgr/
试管婴儿	sgye/
分娩	fm_9780/
双性恋	sxl/
皮质性遗忘症	pzxywz_9784/
淋巴结结核	lbjjh/
硬斑	yb_9786/
足外翻	zwf_9787/
梦游症	myz/
副耳	fe/
腕枪刺状畸形	wqczjx/
剥脱性皮炎	btxpy/
单次发作抑郁症	dcfzyyz/
撕脱骨折	stgz/
植物神经功能障碍	zwsjgnza/
孤独症	gdz/
痔核	zh_9796/
发育性骨盆异常	fyxgpyc/
成人多动症	crddz/
舌炎	sy_9799/
足癣	zx_9800/
丧偶后适应性障碍	sohsyxza/
痢疾	lj/
信息成瘾	xxcy_9803/
胸廓畸形	xkjx/
遗传性肥胖	ycxfp/
表演型人格障碍	byxrgza/
病理性REM睡眠	blxremsm/
传导性腹痛	cdxft/
β-氨基酸尿	_ajsn/
气压伤	qys/
内分泌功能亢进	nfmgnkj/
糙皮病样皮疹	cpbypz/
先天性X因子缺乏	xtxxyzqf/
先天性少白头	xtxsbt/
营养代谢缺乏	yydxqf/
心脏淤积淀粉样物质	xzyjdfywz/
高睾酮血症	ggtxz/
低氯性碱中毒	dlxjzd/
病理性近视	blxjs/
溶血性黄疸	rxxhd/
珍珠丘疹	zzqz/
运动性闭经	ydxbj/
增殖体肥大	zztfd/
强迫型人格障碍	qpxrgza/
冲动型人格障碍	cdxrgza/
细菌性心内膜炎	xjxxnmy/
完全流产	wqlc/
风湿性血管炎	fsxxgy/
鼻前庭囊肿	bqtnz/
化学性支气管炎	hxxzqgy/
盲肠阿米巴肉芽肿	mcambryz/
Asperger综合征	aspergerzhz/
传导性耳鸣	cdxem/
血管痣	xgz/
病理性神经损伤	blxsjss/
锥体外系损害	ztwxsh/
咽喉炎	yhy/
氨基酸尿症	ajsnz/
烟草依赖综合症	ycylzhz/
